것	A thing / an object
하다	To do
있다	1. to be (in a place); to exist 2. to have
있다	To be
되다	to become; (of a time) to come, to arrive
수	way, method, means
나	I
그	He, That
없다	Do not exist, absent
않다	To not do
사람	Person
우리	we, our
이	A person, This
아니다	To not be
보다	To see, to watch, to look at
등	rank
때	occasion; time
거	thing
보다	to try out (+auxiliary)
같다	To be similar
주다	To give, to do for a person
대하다	Face, confront
가다	To go
년	Year
한	One, a single
말	words, speaking
일	Work
때문	Because of
말하다	Speak
위하다	To do for the sake of
그러나	However / but still
오다	To come
알다	To know
씨	~ Mr.
그렇다	That is right / yes.
크다	To be big, large
또	also, too
일	day
사회	culture, society
많다	many, much
안	~ not ~ + VERB
좋다	To be good
더	More
받다	Receive
그것	That thing
집	House
나오다	Come out
따르다	follow
그리고	And / and then
문제	question, problem
그런	Such a
살다	To live
저	That
못하다	Be impossible
생각하다	To think
모르다	To not know
속	The inside
만들다	To make
데	Place, point, instance
두	two
앞	In front of, before
경우	A case / an instance
중	The center, the middle
어떤	What kind of, what sort of
잘	Well
그녀	She
먹다	Eat
자신	one's own self, one's own body
문화	culture
원	A unit of south korean money, KRW
생각	Thought
어떻다	how, what do you think of
명	Person counter
통하다	Run, lead; flow; go through
그러다	and so, and then, well
소리	A sound, noise
다시	Again
다른	Different
이런	Such, like this
여자	woman, female
개	Unit / piece
정도	grade, degree
뒤	back, latter, rear
듣다	to listen, to hear
다	All, everything
좀	A little
들다	to enter/go into; stay at hotel/inn
싶다	want, hope
보이다	see, catch sight of
가지다	To have / take / hold
함께	Together, with
아이	Child
지나다	pass, elapse, go on
많이	A lot
시간	Time
너	You
인간	A person, a human being
사실	The truth, a fact
나다	To be born
이렇다	Like this
어머니	Mom
눈	Eyes
뭐	1. Huh? 2. something
점	point, spot
의하다	To be due to, owing to
시대	An age, period
다음	Next
이러하다	Be this way, be like follows
누구	Who
전	Before
곳	a place
여러	many, various
하나	One
세계	World
버리다	(following a verb) the verb's action is over, perhaps in a sad way
위	The upper part, above
운동	Motion, movement
퍼센트	Percent
학교	School
자기	Oneself, number one, numerouno, self
가장	Most
대통령	The president
가지	One of the kind / a sort
들다	to hold, to carry; to give
시작하다	To start, begin
바로	Right, correctly
어느	Some, a certain
그래서	And so accordingly
무엇	That thing, whatever
정부	Government
모든	Every one
번	Number, how many times
그거	That thing
돈	Money
국가	A state / a nation
그런데	But / however
날	Day
여기	A hobby
모두	Everybody
여성	Female
동무	A friend
마음	Heart
후	After
놓다	Put, place
관계	Connection / relation
아버지	Father
남자	Boy
어디	Where
몸	body, physique
얼굴	Face
들어가다	to go into; to enter
왜	Why
나타나다	Come out, appear
말다	Cease
지역	An area, region
다르다	Be different
모습	shape, body
물	Water
만나다	Meet
내다	produce something
보이다	to show, to cause to see
쓰다	To write
이것	This thing
없이	Without
이번	This time
길	Road
생활	lifestyle, livelihood
쓰다	to use, to take (medicine)
지금	Now
뿐	only, alone, merely
사이	space between 2 points; the relationship between 2 people
방법	Way, method
새롭다	To be new, novel
우리나라	Korea
앉다	To sit down
처음	First
손	The hand
몇	A few
그때	Then / at that time
과정	Process, course of events
삶	Life
갖다	to have, hold, own
찾다	seek, look for
특히	Especially
시	Time
이상	More than, above
나가다	To go out
이야기	Conversation, talk
교육	Education
사다	To buy, purchase
경제	Economy
아직	Still
잡다	seize, catch
같이	Together
선생님	Teacher
예술	Art, an art
서다	To stand
못	Cannot
역사	History
읽다	To read
이제	Now
결과	Result
내용	Contents
물론	Of course
동안	interval, period of time
책	A book
일어나다	To rise, get up
당신	Formal you
시장	market, fair
넣다	Put in, set in
중요하다	To be important, weighty
무슨	What, what kind of
느끼다	To feel
어렵다	To be hard, difficult
힘	Power
너무	Too much
나라	A country
부르다	To call
의미	A meaning, a sense
자리	seat, spot
밝히다	To light up
죽다	die, pass away
이미	Already
쪽	Way, direction
정치	Politics
국민	The people / a nationality
생명	Life
얘기	Story
학생	Student
연구	Research
엄마	Mom
이름	Name
내리다	Descend
사건	An event, incident
및	As well as
쉽다	To be easy
짓다	To make, build; to form a line (a group)
또한	also, too, furthermore
이유	Reason
또는	if not; alternatively
필요하다	To need
글	words, a verse
생기다	arise, occur, happen
사용하다	To use
남편	Husband
들어오다	to enter, to come in
밖	The outside
세상	The world, society
작다	Small
타다	Ride (a vehicle)
대학	University
작품	A work of art
상황	State of things
가운데	In the middle
보내다	Send
두다	To put, to leave behind, to preseive
즉	namely, that is to say
따라서	therefore; in accordance with
상태	condition, state
이후	After that
당시	At that time
문학	Literature
더욱	More and more
아주	Extremely
지방	A locality, district
밤	Night
높다	High
최근	Recently
채	As it is, no change
현실	Actuality, reality
환경	Environment
컴퓨터	Computer
먼저	First
다니다	Go to and from a aplace
얼마나	How many, how much
자체	one's own body
열다	Open
머리	Head
묻다	to Ask
남다	Remain, be left over
부분	part, portion
기업	An enterprise / business
거기	There (location)
변화	Change, transformation
아들	son, baby
뜻	meaning; sense
아	Oh dear
기다리다	To wait
떨어지다	to fall; tumble; drop
선거	An election
관하다	Refer to / be about
분	Minutes
그냥	Just because / in that condition
나누다	To divide
이용하다	To use, make use of
거의	Almost / nearly
곧	Soon
중심	The nucleus, the focus, the heart
활동	Activity
오늘	Today
서로	mutually, one another
관심	Concern / interest
역시	As expected, likewise
이거	This thing
애	A baby / a slightly derogative word for person
광고	Advertisement
방	A room
정신	mind, spirit
이르다	To reach, arrive, get at
땅	earth, land, soil
이루다	Accomplish, complete
아침	Morning
웃다	To laugh, smile
현상	The present situation, state
떠나다	to leave, to exit
기술	Art / technique / ability
전체	The whole, the entire section
그래	So / yes / that's right
얻다	Get, obtain
아름답다	To be beautiful
끝	The end
민족	race, nation, people
간	The interval between
조사	investigation, inquiry
듯	To be like something
입	Mouth
그대로	Like that
영화	A movie
필요	Need, requirement, necessity
줄	way, method
하늘	The sky
년대	Year
과학	Science
듯하다	to be regarded as; to appear to be
자연	Nature
정말	true / genuine; Really
구조	Construction / structure
결국	After all / in the end
밥	Rice, a meal
입다	To wear
오히려	Rather, preferably
프로그램	Program
네	Yes
이루어지다	Get accomplished, achieved
남	Others, other people
하루	A day
그림	A picture
적	The time, the occasion, when
터	one's status, one's lot
마시다	To drink
치다	to attack, assault
혼자	Alone
교수	Teaching / instruction
술	Alcohol
사랑	Love
의식	consciousness; awareness
전화	Telephone
끝나다	To draw to a close / to end
돌아오다	to return, to come back
맞다	Be right, correct; to match, be fitting for
아빠	Dad
걸리다	To be hung up / suspended
지키다	Protect, maintain
한번	Once
커피	Coffee
가슴	Chest
길다	To be long
바라보다	Look at, watch; to look forward to, hope for
알아보다	To investigate, examine, search
회사	A company
맛	Flavor
대부분	Most
산업	Industry
매우	Very
오르다	Go up, climb, ascend
음식	Food
표정	Facial expression, look
꼭	For sure
일부	A part, a portion
요즘	Recently, nowadays
계획	A plan / a project
느낌	Touch, feel
얼마	How many, how much
고개	head; nape of the neck
성격	Personality; character, nature
계속	Continuously
세기	Century
세우다	To stand up (an object), to erect
아내	Wife
가족	Family
현재	The present time, now, at present
세	Three
발전	Development
차	A vehicle, train/auto car
놀다	Play, amuse oneself
향하다	To face, look out on
관련	Relation / connection / reference
형태	Form, shape
각	Each / every
도시	City
작업	Work
분위기	atmosphere, surroundings
그러하다	To be so / right
나이	Age
우선	First of all, before everything
믿다	Believe
바꾸다	change, exchange
낳다	To give birth
바	A thing, what
정보	information, intelligence
열리다	Open, be opened, be unlocked
좋아하다	To like, be fond of
그리다	Picture / draw a picture
만큼	Of that amount
배우다	To learn
시	poem, poetry
역할	A part, a role
옆	Next to
행동	Action, behavior
어	Oh, well, why
국내	Inside the country
비하다	Compare to
기관	An engine / a machine
입장	A position, situation
만하다	Be of the extent of
예	Example
아래	The bottom, the lower part
방식	A form, method, process
영향	Influence, consequences
그럼	Certainly / of course
나서다	Come out, come forth
흐르다	Flow, stream
깊다	Deep
배	A boat (boating)
내	Inside
모양	A shape, form
산	A mountain
새	New
하지만	But, nevertheless
조건	condition, stipulation
문	Door
꽃	Flower
단계	A step, phase
올리다	Raise, lift up
그동안	During that time
교사	Instructor
갑자기	Suddenly
넘다	Cross / go across
지니다	Carry with, hold, possess
바람	Wind
잘하다	To do well
마을	Town
어리다	To be very young, juvenile
대표	Representative
가능성	Possibility
방향	Direction
대회	A great meeting
목소리	Voice
노래	Song
바다	Sea
힘들다	To be hard, difficult
공부	Study
움직이다	To move, stir
의원	A member
노력	Effort
전혀	entirely, utterly, completely
언니	Older sister (female speaker)
단체	A corps, a group
알려지다	To become known
가능하다	To be possible
능력	Ability, capability, how much and how well
주장하다	To assert, maintain
자식	one's children
돌리다	to turn (e.g. A clock), to spin
불	Fire
주민	inhabitants, dwellers
모으다	gather, get together
자료	materials, data
존재	Existence
학년	A school year
신문	A newspaper
이해하다	To understand
제품	Manufactured goods
분야	Field
선생	Teacher
돌아가다	to return, to go back
사업	Business
행위	An act, deed, behavior
수준	Level
지난해	Last year
표현	Verbal expression, representation, manifestation
기분	Mood
대	generation; replacement
젊다	To be young, youthful
동시	the same time; concurrently
옷	Clothes
기능	Function / functionality
순간	A moment, a second
전쟁	War
꿈	A Dream
할머니	Grandmother
회의	A meeting, a conference
방송	Broadcast
이야기하다	To talk
나무	Tree
자다	To sleep
연극	drama, a play
마찬가지	The same
걷다	To walk
노동	Labor, work
이때	At this time, moment
과거	The past
가치	Price
집단	A group, a collective body
현대	The present age, times
살펴보다	Watch closely
장관	A government cabinet minister
차이	difference, disparity
풀다	Untie, loosen; to melt into
시절	season, time, occasion
물건	A thing
직접	Directly
개인	Private / individual
근데	But / however
발	Foot
작가	writer, author
효과	Effect, effectiveness
불교	Buddhism
끌다	Pull
대로	Like, according to
빨리	Quickly
시작되다	To begin, start
둘	two (with counters)
설명하다	To explain
우주	The universe
시기	An opportunity, chance
마치	As though, as if
살	Years old
생산	1. production 2.birth
바라다	Wish, hope
강하다	To be strong / powerful
경험	Experience / undergo / suffer
음악	Music
최고	The best
나타내다	Show, display
아프다	To hurt
적다	To be small, few in number
비	Rain
고향	Hometown
놀라다	Be surprised
다양하다	To be various, diverse
울다	To cry, weep
농민	A farmer
드러나다	to appear, to become manifest
은행	A bank
지내다	To pass, spend time
결혼	Marriage
동생	younger sibling
법	A law, the law
소설	A novel, fiction story
오후	The afternoon
질서	Order, system
담다	Put in a bottle
모이다	Meet, assemble
시민	Residents of a city
회장	Chariman, the president
빠르다	Be fast, quick
스스로	On its own, of its own free will
아기	baby, infant
아저씨	Sir, calling an unknown male
옛날	Ancient times, antiquity
이날	Today, this day
제대로	As properly is suitable
달	The moon
던지다	To throw
참	really, truly
공간	Space / room
이곳	This place, here
딸	daughter (female child)
마지막	Last, final
벌이다	1. to plan to start a job/project 2. to play a table game
병원	Hospital
자세	Position, posture
강조하다	Place empasis upon
경찰	The police
맡다	Take charge of
저녁	Evening
한편	One side, one way; on the other hand, while
그러면	If so / if that is the case
기자	A journalist
넓다	Broad
시험	A test
잠	Sleep
주로	principally, mainly
훨씬	By far, very much so
면	Side
통일	Unification
들어서다	to enter, to take up a position, to occupy
건강	Health
가깝다	Close
건물	Building
시설	establishment, institution
외국	A foreign country
밑	The bottom
어른	A man, an adult
주변	A circumference
대신	Instead of
원인	A cause, a factor
팔다	To sell
차례	1. order, precedence 2. one time, one round
군	An army
열심히	Enthusiastically, with zeal
일하다	To work, labor
재산	property, fortune, assets, possessions
조금	A little
팀	Team
부모	Parents
약간	a little, a bit; somewhat
언어	language, speech
요구하다	To demand, claim, request
올라가다	To go up, ascend
첫	First
감독	The director
그날	That day / that same day
자주	Always, constantly
당하다	Have, encounter
삼다	Make a thing of
약	About, approximately
기간	A period / a time or
담배	Tobacco
일으키다	Raise, get up; start, commence
일단	Temporarily
할아버지	Grandfather
조직	Organization (composition, structure)
태어나다	To be born, see the light of day
공장	Construction site
벌써	Already
즐기다	Enjoy oneself, take pleasure, delight
지	since, from
환자	A patient
변하다	Change
사고	An accident
그래도	All the same
아무리	However much
맞추다	Adjust, adapt
쌀	Uncooked rice
일반	universal, common, usual
재미있다	interesting, fun
가르치다	To teach
대화	Conversation
막다	Stop, obstruct
올해	This year
형	An elder brother (male speaker)
달리	Differently
붙이다	affix, put on
인물	A man, a person
늘	Always
전국	The whole country
마치다	Finish, complete
전	whole; entire
다만	Only, merely
도움	Help
가정	Family
걸다	Hang up / suspend
빠지다	To fall into
멀다	To be far
버스	Bus
오늘날	These days, nowadays
잠시	For a little while, temporary
농업	Agriculture
대다	Put, place up to
식	form, style
의견	An opinion, a suggestion
무대	Stage
사진	Picture
주장	assertion, insistance
표현하다	To express, make known by saying
인하다	To be due to, caused by
이상하다	To be strange, queer
제일	The first
붙다	Stick, adhere to
아마	Probably
얘기하다	To tell a story
잇다	Join, connect
경기	Race / match / contest
목적	goal, purpose
태도	attitude, comportment
남성	Male
주위	The circumference, the girth
대책	Countermeasure
그만	That much / a little amount
발생하다	Originate, come from
다리	Leg
아무	anybody, everybody
어쩌다	By chance, accident
재료	stuff, material
각각	Each and every
결코	Never / by no means
옮기다	Move, transfer 2. (sickness) communicate, transfer to
항상	Always
해	A year
잃다	To lose, to miss, to be deprived
자유	Freedom
책임	Responsibility
바뀌다	Be changed
비슷하다	To resemble
심하다	To be extreme, intense
경쟁	Competition / rivalry
달러	Dollar
사랑하다	To love
아니	No!
여름	summer, summertime
자라다	To grow up
회	A time, an inning, a round in a game
구체적	Concretely
기회	An opportunity
실시하다	To enforce, put into effect
지구	The earth
번째	How many times
소비자	A consumer
싫다	To not like, to hate
규모	Scale / scope / structure
기준	A standard / basis
말	end (of a period); late
반드시	Most certainly
셈	An intention, design, purpose
갖추다	Make / get ready / prepare
그러니까	And so it is that
받아들이다	Accept
값	Price
현장	on site, on location, at the site in question
건설	Construction
꺼내다	To get out / draw out
노동자	Laborer, worker
동네	neighborhood
언제나	everytime, always
완전히	completely, perfectly
자동차	Car
전하다	To transmit, convey
존재하다	To exist
개월	Each and every month
맞다	to take as a courtesy, to receive a guest
별로	Especially, particularly
어린이	A youngster, a child
정하다	To set, determine
한마디	One word
유지하다	To preserve, maintain
이데올로기	Ideology
공부하다	To study
대중	The masses
늘어나다	Grow longer
닦다	Wipe clean, polish
만	As many as, full, complete
말씀	Speech
괜찮다	To be okay
눈물	A tear
각종	All sorts / varieties
빛	Light
피하다	avoid, keep away
거치다	Pass / go through
나아가다	Advance, go forward
야	(Word to get somebody's attention) Hey!! 2. impolite speech for 이다, to be
지식	Knowledge, information
여전히	As it used to be, as before; still, persistently, even still
주인	The head of a family, the owner
발견하다	To discover
선	A line, a route
인류	The human race
특징	A special feature, a distinguishing feature
드리다	humble form of 주다 (juda); to offer, to give, to present
선수	An athlete
형식	A form, formality, mold
마련하다	To plan, arrange
반	Half
발표하다	To announce
주제	Subject, theme, topic
걸치다	1. put a thing over / across 2. to range from A to B
겪다	Experience / undergo / suffer
관점	A point of view / a standpoint/outlook
귀	Ear
기본	A foundation
미터	Meter
사라지다	To disappear
어떠하다	To be how
감정	Feelings
기억	A memory
놈	A fellow
인기	Popularity
배	abdomen, belly
아파트	Apartment
가끔	Sometimes
구성	Organization / constitution, the framework of something
술	scoop; spoonful of
실제로	In reality
짧다	Short, brief
고맙다	To thank
관리	Management / administration
그곳	That place
달다	to ask to do: to demand
보다	relatively, more
비롯하다	begin, start
과연	Just as one thought
들리다	(passive) to be heard; (causative) to cause to hear
달리다	run, make do fast
바쁘다	Busy
이전	Former days/times
인정하다	To acknowledge, authorize
자	A person
중앙	The middle and the heart
나쁘다	To be bad
불구하다	Deformity, malformation
시키다	To make
게임	Game
국제	International
그룹	Group
인생	Life
전통	tradition, convention
기르다	Educate / train / cultivate
잔	A cup, wine glass
조사하다	To examine, investigate
커다랗다	To be very big/large
시인	A poet
언제	when, at what time
외	Except, save for
평가	Evaluation, appraisal
내려오다	Come down
위치	A position, a location
줄이다	reduce, decrease
가격	Price
달라지다	To change, vary
비다	To be empty, vacant
삼국	Three countries
손님	Customer
원하다	To want
통신	communications, correspondance
확인하다	To confirm, corroborate
모임	A group, a party
수	number
웃음	Laughter, a smile
기계	An instrument / a machine
물질	matter, material
아나운서	Announcer
뉴스	News
살아가다	Lead a life, get along
펴다	Spread out, unfold
배	double, twice, twofold; times, -fold
수업	school, teaching
겨울	Winter
종교	religion, a faith
층	floor, grade, class
자연스럽다	To be natural
장	One piece of sth flat (paper); sheets
돌다	to revolve, rotate, spin, turn
식사	A meal
안다	To hold, embrace
이해	Understanding
잊다	To forget
제시하다	To present
반	party; group; class at school
불과하다	Nothing more than
혹은	If that's not the case
엄청나다	To be absurd, wild, terribly large
편	Direction, way (the wind is blowing that ~)
텔레비전	Television
파악하다	Grasp, seize, understand
편	volume (of set of books)
실천	Practice
노력하다	To try hard, strive
보호	protection, shelter
씻다	To wash, cleanse
한편	One side, one way
늦다	To be late (time)
이웃	The neighborhood
편지	Letter
공동	Association / union / collaboration
까닭	Reason
방안	A plan, scheme
센티미터	Centimeter
팔	An arm
분명하다	To be clear/obvious
분석	Analysis
소녀	A young girl
지나가다	To pass, elapse
차	second; next, subsequent
상품	Product
설명	Explanation
훌륭하다	To be excellent
관계자	The interested / affected parties
새로	newly, anew
세	years, years old
이어지다	Get joined, be connected
티브이	TV
봄	Spring
종류	kind, sort, species
낮다	Be low
어깨	Shoulder
지적하다	To indicate, point out
부부	Man and wife
오래	Long, for a long time
요구	A demand, claim, request
키우다	To raise, bring up, rear
눕다	Lie down
발달하다	To advance
발전하다	To develop, grow
여행	Trip
죽음	Death
고통	Suffering / agony
등장하다	to enter the stage; to come into play
공	Ball
듯이	nearly, as if
어울리다	To be becoming, suiting
오월	May
쉬다	to relax, take a break
알리다	To inform, tell a person
차다	To be full, to be filled with (PASSIVE)
과	A lesson / a section / a department
멀리	Far away
빼다	Pull out, extract
예정	A program, schedule
오빠	Older brother (female speaker)
즐겁다	Be pleasant, agreeable
한계	Boundary, limits
흔히	Generally, commonly; often
바탕	Natural disposition; to go all out in a fight; the background
사월	April
싸우다	To fight
예쁘다	Pretty, lovely
갈등	Conflict / troubles
느껴지다	Feel
의지	will, volition
전문	A specialty
정확하다	To be exact
초기	The early days, the initial period
나중	The last, the latter part
등	back, spine
맛있다	Delicious
며칠	How many days
신경	nerves (medicine); feelings
찾아오다	To go meet somebody, to go get sth
미	beauty, grace
사용	use, emply
시선	one's line of vision
아무런	No sort of
언론	A speech, discussion
투자	Investment
지원	helping, supporting, aiding
결정하다	To decide
경영	Management / administration
목표	goal, object
성장	Growth
숲	Forest
없어지다	To lose, get lost
작년	Last year
내려가다	To go down
떠오르다	to rise, to arise
미치다	To reach
새벽	dawn, daybreak
쓰레기	Garbage
얼른	Fast, quickly, rapidly
임금	Wages, pay
피해	Damage
한	limit; end; bound
무섭다	fearful, dreadful
직장	one's work place
참다	to bear, endure
크기	Size, dimensions
고기	Meat
남기다	To leave behind
서양	The Western countries
주요	The major, the chief thing
지나치다	Go too far, to go to extremes
가져오다	To bring / get
냄새	Smell
부드럽다	soft, tender
여기다	Think, consider as
공연	A public performance
남녀	Man and woman
내놓다	Put out, take out
떼다	to detach, to remove, to take off
만들어지다	Make, create
속도	Speed
심각하다	seriousness, gravity
준비	Preparation
계속되다	To continue
구월	September
맑다	clean, pure
소년	A boy
소식	News, information
유월	June
작용	action, operation, effect
허리	The waist, the small of the back
골	Goal
공업	The industry / manufacturing industry
그중	Among the rest of them
노인	Old person
벌다	To earn (money); 2. to invite, to bring onto oneself
살리다	1. revive, bring around, restore to life 2. save, spare, rescue
새	bird
영어	The english language
출신	A native, place one is from
결정	A decision / determination
경향	Tendency / trend
기록	A record / a document
나름	Depending on
대답하다	To answer, reply
반면	One side
썰다	Chip, mince, dice
움직임	movement, motion, activity
이미지	Image
터지다	Break, be torn, get away from
특성	A special/unique characteristic (individuality making, peculiarity)
교장	Principal
벗다	Take off, remove
업무	Buisness, duty
입시	An entrance examination
준비하다	To prepare
청소년	Young boys and girls, teenagers
돕다	to help
응	Yes, i see!
이기다	To win
찾아보다	To go meet somebody
취하다	To adopt, assume, take
다루다	Treat, deal with
사장	Company boss
삼월	March
그렇지만	But / however
선배	one's senior
업체	A business enterprise
키	stature, height
구하다	look for / seek / want
국회	The National Assembly
그러므로	So / hence / therefore
포함하다	To include, contain
걱정	Worry
결혼하다	Get married
만약	If
바르다	Be straight; be honest
세월	The times, things
숨	A breath
행사	An event, a function
깨닫다	to realize sth
누나	Older sister (male speaker)
신	God
왕	King
점점	More and more, by degrees
질문	A question, a query
특별	Be special, extraordinary
판단	A judgment, a conclusion
해결하다	To fix a problem, solve a question
거리	Distance
계속하다	To continue
그치다	Stop / cease / halt
근처	Nearby / the vicinity
너무나	Extremely
높이다	Raise, elevate
부정	injustice, wrongfulness
사정	Circumstances
도대체	In the world, on earth
막	rough, careless, of low quality
부모님	Parents
수출	Exporting sth
계시다	(someone esteemed) to stay / be located
자르다	cut, chop
데리다	Be accompanied by
마리	Number of animals
무척	Extremely
비용	Expense
비행기	An airplane
옳다	To be right, correct
원래	originally, primarily
처리	handling, treatment
최초	In the very first, in the beginning
꼴	Shape / form / appearance
놀이	Play, game
뜨겁다	to be hot: to be passionate
뿌리	A root
수입	Importing sth
초	Initial, in the beginning, first
그리하여	And then / and so / and now
낮	Daytime
일찍	Early
직원	Staff
찍다	Stamp with a dojang
가볍다	Light
내부	The inside
다소	1. Large and small, 2. more / less
상대	counterpart, companion, rival
오전	Morning, a.m.
피부	Skin
가게	Store
가득	Full
그저	1. still / all the time 2. easily / with no effort
도	Degrees (temperature)
벽	A wall
장군	A general
무역	Trade
부담	A burden, responsibility
약속	A promise
인사	Greetings; personnel matters, human resources
줄	string, rope; line, row, column, queue
쳐다보다	To look up at
충분히	Enough, sufficiently
대	platform
신체	The body
에너지	Energy
위원	A member of a committee
정리하다	To adjust
집안	Inside the house
배경	Background
죽이다	To kill
단순하다	Be simple-minded
반대	Opposite and being opposed to (objecting to)
법칙	A law, a rule
소금	Salt
오염	Contamination, pollution
자전거	Bicycle
참여하다	To participate in, take part in
탓	fault, blame
푸르다	To be blue, to be green
걔	Child
목	The neck
발표	Announcement
범죄	A crime
위	status, position
흔들다	Shake, sway
기초	The foundation
논리	Logic
드라마	drama
뽑다	Pull out, draw
피우다	To make, build, kindle
감각	Sense / sensation / feeling
미리	Beforehand
부족하다	Be short of, lack
인사	Greetings
저희	We
진행되다	To have progressed, be advanced
교통	Traffic / transportation
기구	institutional organization, Structure / framework
오랜	For a long time
젊은이	Young person
후보	candidature, candidacy
거리	street
과제	A subject / a thesis / homework; an exercise/a problem
근거	Basis / foundation
기록하다	To record and write down
다가오다	Approach
불다	Blow
시각	angle/point of view. 관점.
이끌다	To guide, lead
종합	Synthesis
조선글	Korean writing system
가을	Autumn / fall
개발하다	Develop / exploit / open up to development
내일	Tomorrow
떨다	to tremble
매일	Every day
손가락	a finger
수단	means, way
자유롭다	To be free
적극적	Positively
판매	Sale, selling
형성	Formation
기울이다	Tip / slant / incline
길이	Length / extent
장면	A scene, situation
점차	gradually, in steps
톤	A ton
관련되다	Be connected / related to
급	Class / grade / rank
나머지	The rest, the remainder; as a result of the excess of, as a result
날씨	Weather
더불다	Join in, do together
동물	animal
의사	A doctor, a physician
개방	Open / throw open
건강하다	To be healthy
미래	Future
앞서	Before, previously 2. in anticipation, beforehand
여러분	You (plural, to address a group at speech time)
왜냐하면	Because
인구	Population
기대하다	To expect / look forward to
도착하다	To arrive
병	Sickness
소프트웨어	Software
흘리다	spill, shed (tears, blood)
반응	Reaction
주인공	The head of a family, the hero/heroine
당연하다	Be natural, be no wonder
따뜻하다	(to be) warm
따로	differently; separately
비판	criticism, a comment
빌리다	To lend
세대	Generation
축구	Football
형님	The respectful, proper way a man refers to an older friend
놓이다	Be put on top of something else 2. to become peaceful
당장	On the spot, immediately
무렵	The time when
밝다	To be promising
사물	objects, things
일반적	Universal, general
장소	Place
곱다	Beautiful
바닥	Floor
새끼	Baby animal
생각되다	To come to think sth
서비스	Service
선택하다	To choose
심다	plant, sow (a tree)
적다	write, write down
코	The nose
간단하다	To be simple
고등학교	A senior high school
공개	opening to the public, making public
교실	Classroom
견디다	Endure / bear
기사	An article / an account
막히다	Be stopped up
매체	A medium, medias
별	A star
복잡하다	Be complicated
뿌리다	sprinkle, scatter
영역	Territory
체험	An experience
구속	To arrest / put in detention
때로	on occasion; occasionally
어쩌면	1. it is possible that 2. how on earth, how the hell
극복하다	To overcome / surmount
불법	Illegal
비밀	A secret
색	Color
쓰이다	To be used, to be utilized/employed
일정하다	To be regular, established, uniform; changeless, constant, certain, definite; invariable (mathematics)
다지다	Make sure, to harden oneself, firm up one's will
밝혀지다	To be discovered, revealed.
아까	A little while ago
알맞다	To fit, be fitting, suitable
이념	An idea, a doctrine, ideology
희다	White, fair
가리키다	Point to / indicate
모시다	Attend on
발달	Development, growth
수많다	Many and many
잘못	wrong, mistake
치르다	Pay off, pay one's bill
평화	Peace
공사	Construction work / engineering work
돌	stone, pebble
똑같다	just the same, exactly equal, identical
박사	Doctor
성	a sex (male / female), a sexual gender
전문가	A specialist
단지	Simple, merely
말씀하다	Speak
무용	dancing, a dance
불리다	To be called
싸움	A fight
자꾸	Constantly, repeatedly
차리다	Make ready, prepare
해외	Abroad, foreign countries
그리	So / to that extent
뜨다	to float, to stay afloat (on water)
문화재	Cultural assets
미소	Smile
보통	The normal
식당	Restaurant
의미하다	To mean, signify
이래	Since, after that, hereafter
체육	Physical education
구성되다	To be organized
독특하다	Unique, characteristic, distinctive, peculiar, specific
땀	sweat
사례	thanks, gratitude
소개하다	To introduce, present
잘되다	To turn out well
추진하다	To propel, drive forward
칠월	Month of July
틀	A frame, framework; mold
평균	Average
훈련	Training
흐름	Flowing, a stream/current
십이월	December
쌓이다	Be piled/heaped up
이익	Profit
쥐다	To hold, seize
컵	Cup
게다가	In addition
끓이다	Boil / heat / make hot
논문	Dissertations, an academic paper (these are 2 separate meanings)
멈추다	Stop
사용되다	Be used, be employed
오랫동안	For a long time
위기	A crisis, an emergency situation
정당	A political party
종이	Paper
찾아가다	To go to a place to meet somebody
폭력	voilent, brute force
혹시	by any chance, accidentally, maybe
늘다	Increase, gain
양	quantity, volume
절차	process, formalities; 수속
진짜	Real
공기	Air
닿다	To reach, get to
속하다	Belong to, be affiliated with
올림픽	Olympic
이외	Except, apart from
재미	amusement, enjoyment
제공하다	offer, proffer
증가하다	increase, rise, grow
기대	Expectation
떡	rice cake; tteok
식물	plant
옛	Old, ancient
외치다	To shout, scream
적어도	At the least
편하다	Untroubled from cares
평	a Pyeong, a square area about 2 square meters
권리	A right / a claim to
끝내다	To end
대답	An answer
시작	The beginning
어려움	difficulty, hardship
일주일	One whole day
자원	Resources
춤	Dance
넘기다	Pass over, send across
물체	A material body
분명히	Obviously
시위	A demonstration
아무것	Anything
온	All, whole, entire
젖다	To be wet, soaked
제외하다	To exclude
최대	The greatest, the largest
평소	Ordinary times, ordinarily
견해	An opinion / view. Same as 의견
깨끗하다	To be clean / pure
농사	Farming
더구나	also; furthermore
안정	Stability
어둠	Darkness
어둡다	To be dark, dim, gloomy
어쨌든	In any case, anyhow
주택	A house
고장	A district / producing area
관련하다	To be related to / connected to
눈길	Line of vision
물어보다	Ask
미안하다	To be sorry
밀다	push, shove
스트레스	Stress
음	Sound you make to express doubt, worry
인사	figure, distinguished person
주어지다	To offer, proffer (conditions)
고려하다	Regard / respect
과일	A fruit
널리	Widely
농촌	A farm village
올라오다	Come up
챙기다	gather, collect, assemble your stuff — to amass (money, a collection)
고르다	Choose / select
바르다	to hang paper; to stick paper, cloth / the like
벌어지다	to occur / take place.
소재	material, subject matter
전망	A view, prospect
포기하다	To give up, to abandon
형성되다	To be formed, made up
고치다	To fix, amend, change
그림자	A shadow / a silhouette / an image
눈	snow
다하다	Finish, go through, be exhausted, run out of
마침내	Finally, in the end
비교하다	To compare
시월	October
커지다	To become bigger
한쪽	On one side
검사	Investigation / inspection / examination / audit
결론	A conclusion
들이다	To let in someone / something.
맡기다	Entrust sb with sth
박물관	Museum
소문	A rumor
싣다	To load, take (passengers)
쌓다	To pile up
어서	Quickly 2. kindly
자녀	one's children
제목	A subject, theme
짓	Something you do
판결	A judgment (from a judge)
팔월	August
하얗다	White
희망	Hope, wish
가방	Bag
군대	Troops / an army
그만큼	That much / to that extent
무어	What? 무엇
비로소	For the first time
상대방	Conversation partner
서구	Western Europe
소유	Possession
시골	Countryside
실수	A mistake
잘못되다	To turn out wrong
치료	Medical treatment, medical care
폭	Width; range
호	A pen name, a title; a number, an issue
내밀다	To Push out
맞다	be beaten, be hit
부문	A section, department
시리즈	Series
임신	Pregnant
잡히다	To be caught; to extinguish a fire
규정	Provision / stipulation
그램	Gram
밭	A field, farm
분석하다	To analyze
식구	Members of a family, your immediate family members (those you live with, preferably)
아예	From the very first, from the very beginning
어찌	How, in what way, by what means
울리다	To ring (a bell); to create an echo effect
작용하다	To apply, use
확실하다	To be sure, certain
개선	Renovation / improvement / betterment
그릇	A vessel / receptacle
글자	A letter / a character
바람직하다	Be desirable, advisable, to be appropriate, good
연구하다	To research, investigate
착하다	To be nice
개	dog
라디오	radio
마련	planning, making arrangements; provisions, preparations
부동산	Real estate
신화	A myth
양	Miss
점	a point / spot
직업	An occupation, calling
거두다	Collect / gather up
방학	School holidays
범위	Range, area
조상	Ancestors
철학	Philosophy
검다	Black / dark
곁	Neighborhood / vicinity
근본적	foundational, fundamental
너희	You guys
대형	Large, full-sized
따다	to pick, to pluck
문제점	The point at issue
본격적	Exemplary
불가능하다	Impossible
인제	Now
충격	An impact, a shock
퍼지다	Spread out, get broader
금방	Just now / a moment ago
남쪽	South side
누르다	Press / push down
미술	art, the fine arts
백성	The common people
상당히	fairly, considerably
색깔	Color
요리	Cooking
유명하다	To be famous
자네	You
기13	1. energy 2. breath / wind
꽤	Fairly / considerably
외국인	A foreigner, a foreign national
한참	For some time, for a while
군사	Military affairs
끊다	Cut off / sever
넘어가다	Cross / go over
담기다	Be put food in a bottle / for pickling
마당	Garden
부인	A woman
서두르다	To hurry up
지적	Pointing out, indication
짝	One pair, one couple
참으로	really, indeed
충분하다	To be sufficient, ample
기쁘다	To be happy
뛰다	to run
숙제	Homework
앞두다	Have a distance ahead
예산	An estimate, budget
온갖	All kinds, all sorts
우려	worry, anxiety, fear
우산	An umbrella
기쁨	Joy / delight
깊이	Deepness
꾸미다	Decorate
늘리다	Increase, multiply
무릎	A knee
발견되다	Be discovered
보호하다	protect, shelter, guard
시스템	System
이용	usage, to use
지난달	Last month
지르다	Holler, yell, scream
참여	Participation
걸음	Walking / stepping / a step
겨우	Barely / narrowly. 간신히
마르다	Become dry
비교적	Comparatively
애쓰다	Make efforts/pains to do sth
올바르다	Be honest, straightforward
책상	On the desk
춥다	To be cold
흔하다	To be everywhere
높아지다	Become high
늙다	Grow old
단위	A unit, a monad
둘째	second, next after the first; the ordinal number for two
뛰어나다	to excel; to be outstanding
무겁다	Heavy; a stuffy atmosphere
상상	Imagination
소득	An income, earnings
수도	the capital city, e.g. Seoul, of a country
역	theatric / cinematic role
인식하다	recognition, cognizance
자	letter, character
침대	A bed
권	A volume / a book
뜨다	to open (one's eyes)
맺다	form, tie
수요	demand, requirement
스타	Star
시계	clock, timekeeper, timepiece
입술	The lips
잎	A leaf
중간	In the middle
지도자	Leader
천천히	Slowly
구성하다	To organize / makeup
대체로	Generally, on the whole, for the most part
때리다	to hit, to strike, to slap
몹시	Extremely
문득	Suddenly
스포츠	Sports
위원장	A chairman of a committee
저기	That place, there
특별하다	To be special, extraordinary
효과적	Effective
가까이	Close
낫다	to be Superior, better
넘어서다	Pass over
볶다	fry, roast
생산하다	To produce, make
언젠가	One of these days, at some time in the future
예술가	An artist
의도	An intention, an aim
저지르다	do, commit, spoil
줄어들다	Dwindle away
가만히	Quietly / softly
건	A matter / an object / a case
교회	Preach / moral instruction
대개	Mostly, for the most part
외부	The exterior, the outside
한두	One / two
한때	For a while, temporarily
화	Anger (get angry)
흙	earth, the soil
가난하다	Poor
고객	Customer
과학자	Scientist
관광	Sightseeing / tourism
살아오다	To come out alive
상대적	relatively, correlatively
수술	Surgery
식품	Groceries
연기	performance, acting
일월	January
조	article, clause
첫째	The first
회원	A member of a society
도서관	Library
들려오다	To echo (sound)
조금씩	A little at a time, little by little
조미료	seasoning, condiment
풀리다	To come loose
강력하다	To be strong / powerful
들여다보다	To look into
마늘	Garlic
선물	A present, gift
습관	Habit
아주머니	An aunt, a respectable word for a married, older woman
위험	Danger
지하	Underground
활용하다	Utilize, make practical use of
가꾸다	1. grow / cultivatea 2. dress oneself up
고민	Worry / anguish
떠올리다	To make someone think of something; to bring to mind.
맨	bare, naked
법률	A law, statute
상처	Wound
좁다	Narrow
지하철	Subway
집다	Pick up
현	The present, the existence, actuality
화면	Screen
군	Mr.; attached to names / surnames of young men to show a certain level of respect.
대표적	Representative
만일	If, suppose
사회적	Socially
생겨나다	To begin, germinate
이어	vulgarity, slang
주부	A wife
진리	A truth, a fact
태양	The sun
틀림없다	No mistaking it
프로	Professional
피다	To bloom ( a flower ~)
공급	Supply / provision
도로	A road, way
동료	associate, colleague, coworker, comrade, brother
지다	Carry (on the back)
채우다	To fill up, complete, fulfill
균형	Balance / equilibrium
기본적	Fundamental / basic
부족	A tribe
사무실	Office
이월	February
일요일	Sunday
접근	Proximity
지켜보다	Watch, stare at ( wait on some situation)
개성	Individuality / personality
달리다	to hang, weigh
더하다	Get worse
띄다	To be visible / seen
무너지다	Collapse
쓰다	to wear, to put on (a hat, helmet, etc., on one's head; a mask, pair of glasses, etc.)
이러다	do/say think this way
일어서다	To rise to one's feet, stand up
죄	A crime, a sin
총장	The president, the chancellor (university's)
핵심	The kernel, the core
후반	The latter/second half
단순히	Simply
달려가다	Run, rush, dash
방문	A visit
불만	Dissatisfaction
불편하다	To be unpleasant
실제	The truth, a fact
종	A sort, kind, species
피	Blood (is flowing)
강	River
관객	Spectator
동작	movement (of the body); action
뜻하다	to mean; to signify
막	Carelessly, at random
밀리미터	Millimeter
비싸다	To be expensive
숫자	A figure, number
열	Heat
왼쪽	The left side
중세	The middle ages
택시	Taxi
통합	Unity, unification
계산	Calculation
꼬리	Tail
놀랍다	To be surprising
양식	A mode, a style, an order, a modality
예전	Old days, former days
전기	Electricity
주식	Stock
틀리다	To be turned, warped 2. go wrong, be mistaken
끊임없이	Constantly / unceasingly
모델	Model
붓다	to pour (water, liquid)
상식	Common sense
상표	trademark, brand
시원하다	Be cool, refreshing
아니하다	To be/do not
어디	Where?
의식하다	Be conscious of, be aware of
고모	A paternal aunt
궁금하다	To wonder / be curious about
둘러싸다	To surround.
딱	tightly; in a perfectly fitting manner
뛰다	to pulsate, palpitate
민주화	Democratization
보도	news, report
살피다	Take a good look at
약하다	To be weak
잘못하다	To make a mistake
잡지	A magazine
거부하다	Deny / reject / disapprove
공무원	Public servant
그만두다	Stop / discontinue
댁	You and your family
반갑다	Be happy
부족	insufficiency; inadequacy
실시	execution, enforcement
운명	fate, fortune
재정	finances, economy
차라리	rather, preferably
학자	Scholar
다녀오다	Drop in for a short visit
달다	to be sweet, delicious
대규모	large-scale
동	the same
민간	civil, private
법원	Court of justice
비디오	Video
사실상	Actually, in truth
아끼다	grudge, spare
이쪽	This side, our way
지대	Zone, belt, district
판단하다	To make a conclusion
행복하다	To be happy
굽다	To roast / bake
기름	Oil / fat
실천하다	To practice, put in theory
쏟아지다	To pour out
연습	practice, exercise
오른쪽	The right side
용어	Technical terminology
익히다	to become proficient in something, Habituate oneself to
지도	Map, atlas
지위	Position, status
풍부하다	To be abundant, copious, plentiful
화장실	Bathroom
기억하다	To recall / remember
식량	food, provisions
실험	An experiment, test
용기	Bravery
토론	A debate, discussion
핵	A nucleus, core
고급	High rank / first class
고생	A hard life / privation
미치다	(informal, derogatory) to go crazy, to become insane
밟다	Step on
상당하다	Be proper, suitable
섞다	blend, mix
수석	The top seat
없애다	Remove, get rid of, do away with
이뤄지다	To make something for a specific purpose
적절하다	Appropriateness
정상	The top, summit
제사	A holiday ceremony
주말	Weekend
지혜	Wisdom, wits
참새	A sparrow
화장품	Makup, cosmetics
굵다	Be thick / fat
깨끗이	Clean / neatly
낡다	Clear
내년	Next year
농산물	Agricultural products
눈앞	Before one's eyes
대학생	University student
방문하다	To visit
붉다	Be red, scalet
사고	thought; reflection
순서	system, order, sequence
아무래도	Never on any account, no matter what
연구소	A research institute
올	This year
위대하다	To be great, mighty, grand
이사	House-moving
지배하다	Control, direct
틈	A crack, gap, opening
가령	1. For example 2. supposing / admitting
거대하다	Huge / gigantic / enormous
닫다	To close
드물다	to be rare
들르다	to stop by, drop in
매달리다	Be suspended, to be hanging down (from); to stick to a job, to persevere
생일	A birthday
섬	An island
이하	Less than, below
참석하다	To attend, take part in
토대	A foundation, a base
해결	Solution, settlement
행복	Happiness
걸어가다	To go on foot / walk
근로자	Laborer
글쎄	Now / well / let me see
목숨	Life
백화점	Department store
변화하다	To change, vary
병	bottle; jar
빠져나가다	Get/go out of here
안녕하다	To say hello
여론	Public opinion, public sentiment towards sth
의복	Clothes, garments
체조	Gymnastics
출발하다	To depart, leave
현실적	Down to earth, Realistic
화제	Subject of conversation
결정되다	To become decided
고양이	Kitten
공격	Attack
물가	Prices of products
민주주의	Democracy
불안	uneasiness, anxiety
소중하다	To be important, valuable
여유	reserve, surplus
의문	A question, a doubt
중학교	Middle school
킬로미터	Kilometer
파도	Waves, billows
흰색	gray, ash color
가수	Singer
단	Only one, alone
방송국	Broadcasting station
빛나다	shine, glitter
숨다	To be in hiding, to hide oneself
실리다	To be printed, recorded; to be loaded onto a truck (luggage)
압력	pressure, stress
예금	Deposit money
예상되다	To expect, anticipate
입학	Admission into school
증권	securities, document, deed
직후	Immediately after
차량	vehicles, cars
출산	Child birth
물다	bite, put in the mouth
선진국	A developed country
약	drug; medicine
어느새	In no time, quickly
재판	A trial
저쪽	Over there, in that direction
제자	A disciple
창문	A window
초	unit of time, second
치즈	Cheese
회복	Recovery, recuperation
구역	A zone / district
대응	Confrontation, opposition
반대하다	Be opposed to
발휘하다	Display, exhibit
소비	Consumption
심장	The heart
아이고	Oh my god!
조용히	Quietly
중소기업	Small and medium enterprises
직접적	Directly, immediately
진실	Truth, sincerity
필자	The writer, author
협력	Cooperation, cooperate with
가스	Gas
계층	A class / social stratum
구멍	A hole
담당	Charge, undertaking
만화	Cartoons
먹이다	support, feed
무시하다	disregard, ignore; to be defiant and fail to observe
보도하다	To report, inform
살짝	1. softly, lightly, just a little 2. furtively, stealthily
생각나다	To remember
우유	Milk
인상	rise, raise, increase
차갑다	Cold
철저하다	thoroughness, cleanliness
태아	A fetus, an unborn child
관찰하다	Observe / view / watch
괜히	In vain / useless / fruitless, for a stupid reason
끼다	To put on / wear, to wear (a ring)
날개	The wings
녀석	Fellow
눈빛	The glitter of one's eyes
단지	(apartment/housing/work) complex, development
두르다	to surround, to wrap, to wear
드디어	finally, at last
물속	Inside the water
민주	Democracy
성공하다	To succeed
소나무	A pine tree
여기저기	Here and there
여인	beauty, belle
운영하다	manage, administer
평가하다	To evaluate, estimate, judge
표	A marker, indication
필요성	Necessity
감추다	Hide / conceal
머무르다	Stay overnight
모	A certain person, mr. Jones
부위	A region, part
비우다	empty, vacate
설치하다	To found, establish, create
십일월	November
싸다	Wrap in, bundle
아울러	And, both together
지시	Directions, orders
형성하다	To form, make, take shape
형제	Brothers and sisters
화려하다	Splendor, magnificence of a display, a look
거울	1. mirror 2. a pattern / model / exemplar
덧붙이다	Add a thing, append
딴	another, other; different
몇몇	Several
무기	Weapon
세계적	International
안전	Safety
양파	An onion
이상	strange, abnormal, odd, weird, bizarre
일종	A kind, a sort, a species
처지	A situation, circumstances
촬영	Photographing, taking pictures/films
타다	(intransitive) to burn
틀다	To twist, wind
형편	The situation, the state of things (esp. financial)
가지	eggplant/aubergine
감다	Close
고추	Red pepper
규칙	Rules / regulations
본질	True nature, essence
비치다	Shine
빵	Bread
서서히	Slowly, little by little
스승	A teacher, master
신분	Social position
실시되다	To be enforced
아마도	Probably
안방	The inner room
앓다	To be ill, sick with sth
어제	Yesterday
오직	Only, merely, solely
위험하다	To be dangerous
자신	confidence
잠시	a moment, a short time
졸업하다	To graduate
증거	evidence, proof
초점	A focus, a focal point
포함되다	To be included in
호랑이	A tiger
강화하다	Strengthen
공포	Fear / dread
권위	1. Authority / power 2. dignity / prestige
덜	Less, incompletely
둥글다	to be round, circular
미루다	1. to postpone; 2. to guess, infer and make an educated guess
본래	originally, primarily
부엌	Kitchen
세금	Tax
실정	The actual situation
영양	Nutrition
육체	The flesh, the body
입구	Entrance
잔뜩	extremely, to the utmost
적극	The positive
최소한	At least
펼쳐지다	Stretch, extend away
경험하다	To experience / go through
그이	That person / he / him / she / her
넘치다	Overflow
놓치다	Miss, let slip
대기	The atmosphere
독립	Independence
돌아보다	to look back, to think back, to reminisce
또다시	again, once more, once again
머릿속	Inside one's head
북쪽	The north direction
불안하다	To be uneasy, anxious
쇠고기	Beef
위반	Violation, infringement
주	One week
카드	Card
평생	one's entire life, lifetime
해당하다	To be applied/applicable under
간부	The leaders (cadre, exec, executive, management)
관념	An idea / notion
굉장히	Very much / greatly
단어	Word
덮다	To cover, veil
도와주다	To help
도입	introduction, invitation
몰다	Drive; to chase / urge on
배우	Actor
비추다	1. Shed, throw light on 2. to reflect in the mirror
신발	shoes, footwear
알	An egg, spawn (fish)
앞서다	To go before, precede
여건	A postulate, a given condition
오래전	Since a long time before
자격	Qualification
통제	control, regulation
계단	A staircase / a set of stairs
김치	Spicy cabbage
끄덕이다	Nod
낯설다	To be unfamiliar with, to be a stranger to ( a person)
높이	Height (noun)
닮다	Resemble
마음속	Deep in one's heart
못지않다	Be just as good as
반영하다	Reflect, be reflected
뼈	A bone
성장하다	To grow, be brought up
소속	Belong to, attached to
연결되다	Connect, attach
장사	trade, business
제작	manufacture, production
제한	limits, bounds
차다	to kick
추진	Propulsion, drive
취하다	to get drunk, to become intoxicated
콩	A bean
한숨	sigh
헤어지다	Part from, part company with
구입하다	Purchase / buying
날다	To fly
너머	Beyond, on the other side
동기	machine, engine
살	flesh, muscle, skin
선장	A captain
설탕	Sugar
순수하다	To be pure
스타일	Style
시점	Point in time
싸다	to be cheap, to be inexpensive
의사	intent
집중	Concentration
코드	Code
큰일	An important affair, a serious matter
거짓말	A lie / falsehood
대단하다	Considerable, grand
대단히	Extremely
마주	Face to face
세계관	A worldview
온통	Wholly, entirely
의존하다	To depend on, rely on
자세히	In detail
점심	Lunch
정확히	Exactly
지치다	Be exhausted, fatigued
청년	A young man, a youth
혀	The tongue
확대하다	To enlarge, magnify
후춧가루	Ground pepper
건설하다	To construct / erect
경쟁력	Competitiveness
마침	Just, exactly
신용	confidence, trust
연락	Connection, communication
온몸	The whole body
정	Feeling of attachment
정신적	Mental
증상	Symptoms
출연하다	Appear on stage, act, sing
칼	A knife
한꺼번에	All at once
강제	Compulsion / coercion
건너다	Go over / go across
깨다	to regain consciousness; to wake up, to awake, to become sober
낚시	Fishing
다가가다	To get near to
뛰어들다	to run, to rush
문자	letters, character
묻다	(intransitive) to stick, adhere; to be dirty with
비롯되다	To be begun, to have started
슬프다	To be sad, sorrowful
신부	Bride
여겨지다	To look, appear, think of sth as
오징어	Cuttlefish, squid
요금	A rate, a fare
용돈	Pocket money, money for expenses
위주	Put first in importance
음료	A beverage, a drink
의자	A chair
전자	An electron
전해지다	To be transmitted
전환	To exchange, convert, change
지경	A boundary, situation, state
진행	Progress, advance
카메라	Camera
통증	An ache, pain
편리하다	To be convenient, handy
하천	A river, watercourse
현금	Cash, ready funds, not a credit card
화학	Chemistry
활발하다	Be lively, sprightly
가리다	to tell (right from wrong / truth from falsehood), to distinguish (the good from the bad)
거칠다	Coarse (texture) / wild (behavior) / (rain and wind) rough / wild
그나마	Even though / nevertheless
그야말로	really, indeed
껍질	Skin / nutshell
남부	The south part
명령	An order, command
몰래	secretly, quietly
무조건	Unconditional
반장	Squad leader
부근	neighborhood, vicinity
선택	A choice
역사가	Historian
연구자	Researcher
연기자	A performer, an actor
워낙	By nature, primarily, by constitution
정리	arrangment, regulation, adjustment
조그맣다	Be tiny, small
줄기	A trunk, stem, stalk
찾아내다	To find out, discover
토요일	Saturday
경찰관	a policeman
권하다	1. advise / persuade 2. recommend
극장	Theater / playhouse
끝내	The end
대문	A big gate
더욱이	Besides, moreover
별도	A separate way
비극	A tragedy
솜씨	skill, ability
시내	The city
신	joy; delight; amusement
실내	In the room
쏟다	To pour . 붓다
연결하다	Connect, attach
외교	Diplomacy
주머니	Pocket
계약	Contract
과장	The department/section head
극	Drama / play
나란히	In a line, row
다방	Tea room
부끄럽다	Be shameful, disgraceful
성공	success, achievement
수행하다	Accomplishment
신청	application, request
실로	really, indeed
아픔	Pain
알아듣다	To listen and comprehend
약간	Somewhat
연기	smoke
이동	movement, migration, drift
인연	Cause and occasion
일행	A party, a troupe; a row, a line
지도	guidance; leadership
지식인	An intellectual
진지하다	To be serious, earnest
호흡	Respiration, breath
흔들리다	Shake, swing, rock, tremble
근본	The foundation / basis
기온	Temperature
날아가다	To fly away
많아지다	Become a lot
바위	A rock, a crag
버릇	Habit
비판하다	To criticize
빨갛다	deep-red, crimson
세워지다	To become erected
술집	Bar of some kind
오랜만	After a long time
일부러	On purpose, intentionally
전체적	entirely, generally
절반	Half
접근하다	approach, get near
편안하다	comfortable, relaxed, easy, calm
풍경	Landscape, scenery
확실히	certainly, for sure
흩어지다	Scatter about
갈다	rub / chafe
교류	Interchange (cultural); alternating current (electrical)
글쓰기	Writing
기후	Climate / weather
내내	All along, the entire time
대기업	Big enterprise
대응하다	Cope / correspond to
도구	Tool, instrument
매력	fascination, charm, bewitchery
백	Hundreds
보험	guarantee, insurance
부럽다	Be enviable
부장	Head of a department
섞이다	To be mixed, blended
소	A cow
심리	A mental state
심정	one's heart, one's feelings
쏘다	1. To shoot 2. to sting, bite (an insect, animal)
아줌마	Old / married lady
위치하다	To be located
이룩하다	To erect, build
이틀	Two days
전달하다	To deliver
정말로	Really
추다	To dance
켜다	To light, turn on, kindle
코너	Corner
행동하다	To act, behave
형사	A criminal, penal case
희곡	A drama, a play
감동	Agitate / stir up the emotions
공항	Airport
군인	Sb in the military
굳이	Firmly / admanantly
그늘	1. shade 2.parental prodection
급하다	Be urgent / pressing / iminent
달걀	An egg
대중문화	Pop culture
마련되다	To be planned and arranged
마루	A wooden floor, floor, flooring
무게	Weight
물기	Moisture
성적	A result, grade
솔직히	frankly, candidly
시도하다	To try, attempt
아니요	No, that's not the case
예절	propriety, decorum
인상	impression
인터넷	Internet
적용하다	To apply (sth to sth else)
전통적	Traditional
참가하다	To take part in, join
치마	A skirt
친척	Relatives
특정하다	Specify
호텔	Hotel
경계	Boundary
공식	A formula / formality
그다지	So much / to that extent
긴장	Tension
깎다	Cut / trim
다리	bridge
따라가다	to follow, to go after
머물다	Stay overnight
명예	Honor
뱃사람	A seaman, sailor
부처	Buddha
숙이다	Lower one's head
아가씨	Mis, young lady
온도	Temperature
이마	Forehead
절대로	Absolutely
지붕	A roof
지원하다	To desire, aspire, hence to apply for [e.g. a job] / volunteer for sth
짙다	Be dark, dense
창밖	Outside the window
청소	Cleaning
침묵	Silence
텍스트	Text
표면	Front, surface, exterior
햇살	The rays of the sun
객관적	Objective
걱정하다	To worry / be anxious
경제적	Economical
구름	A cloud / the clouds
구석	1. a corner 2. an out of the way place
끄다	Put out / extinguish
담당하다	Take charge of
둥지	nest
벗기다	Unclothe, undress
부대	A detachment, squad
불빛	Fire light
서클	Circle
시청자	TV audience member
실체	substance, essence
엄격하다	To be strict, serious
완벽하다	Perfect
완전하다	To be perfect and faultless
절	A Buddhist temple
종업원	waiter/waitress
증가	An increase, augmentation
출연	Going on stage
학기	An educational term
한동안	For quite a while
후기	The latter term/period
계절	Season
만지다	To touch
목사	A pastor
바늘	A needle, pin
버티다	Endure, tolerate
부	A department, a part
분포하다	Distribution
비중	Specific gravity
수입	income
아이디어	Idea
양쪽	Both sides
예컨대	For example, such as
운동장	Stadium, playground
전개	unfolding, development, expansion
접촉	contact, touch
짐	Luggage; what is on a person
풀	Grass (cut the ~)
해마다	Every year, each year
후배	one's junior
휴가	holidays, vacation
경기	economy, business conditions, boom and bust
계곡	A valley / gorge
국회의원	A member of the national Assembly
다투다	Quarrel
도저히	(도저히 + negative (지 않다/없다))Absolutely impossible; by all means
뻗다	Stretch out, extend beyond
생활하다	To live, make a living
솔직하다	frankness, candidness
안타깝다	To be heart-breaking
앞장서다	To be in the lead/ at the head
요청하다	To ask for, to request
이르다	to be early; fast
일치하다	Agree with, to be in accord with
젓다	To make a sign, gesticulate
정치권	Political rights
처녀	A virgin, a young maiden
축제	a festival
터뜨리다	Break, burst, explode
학습	Learning, education
개발되다	To be developed / exploited
당연히	Of course
대비하다	Provide for, prepare onself for
동쪽	east
떨리다	to shake, to tremble
마구	continuously, without pause
만남	A meeting
미디어	Media
복도	A corridor
수상	The prime minister
쓰러지다	Fall, collapse
영상	An image [picture], reflection (moving pictures, movies)
영혼	A soul, a spirit
운전사	The driver (of a taxi)
자랑스럽다	To be proud
잠깐	For a little while
적당하다	To be appropriate
적용되다	To be applied
지속적	Continuous
진행하다	Advance, proceed
차별	distinction, differentiation
곳곳	Everywhere
구분	A division / section
금지	Forbidden / prohibitted
내지	From A to B
달려오다	Come running
둘러보다	to look around, to take a glance around
분노	rage, anger
비교	A comparison
소위	What is called for
스치다	Graze past
역사적	Historical
열차	Train
요즈음	Recently, nowadays
유난히	uncommon, exceptional
의무	A duty, an obligation
잃어버리다	To lose
잠들다	Fall asleep
정식	Formality, due form
조용하다	To be quiet, still
즉시	At once, immediately
최선	The best, one's best
탑	A tower
한복	Korean traditional clothing
활동하다	To be active, lead an active life
건축	Construction / building / erection
귀엽다	To be cute
답답하다	Feel anxious
당황하다	Be confused
동일하다	(to be) the same, identical, equal
떨어뜨리다	to drop, to lose
똑같이	equally, evenly; impartially
라면	instant noodles, ramen
말	horse
밀가루	Flour
바깥	Outside
바지	Pants
벌리다	Open, wide
보고서	Report
보관하다	Keep in one's custody
부딪치다	Collide with, bump against
빨래	washing, laundry
상하다	damage, injure
설치	establisment, institution
식용유	Food oil
싫어하다	To dislike, be reluctant (to do)
업종	Types of industry
연출	Production, presentation
테이블	Table
트이다	Get cleared out, open up
피곤하다	To be very tired, exhausted
조선말	Korean (language)
한자	Chinese Characters adapted into Korean language
겁	Fear / fright
국제화	Internationalization
근육	Muscles
깔리다	To be spread / overspread
사전	beforehand, in advance
산소	Oxygen
석유	Petroleum
소리치다	To shout, yell
시	town, city
신선하다	Fresh
안경	Glasses
약속하다	To make a promise
연합	Combination, federacy, union
인격	Personality, character
장	One piece of sth flat
적	enemy
조심하다	To be careful
질	Quality, character
찌르다	stab, thrust
책임자	Person responsible
총	all, entire, whole
취미	Hobby
표	table, diagram, / graph
품목	The name of an article, a list of articles
확대되다	To be magnified
거실	Living room
논	A rice field
덥다	Be hot, heated
바보	Ignorant
별	special, extraordinary, different, unusua
보람	worth, result
부작용	reaction, side effect
비난	Criticism, reproach
신고	A statement, declaration
야구	Baseball
어떡하다	To take some measures, to manage somehow
예상	Expectation, anticipation; forecast, preconception, prenotion
위협	Menace, threat, intimidation
이	tooth, teeth
이상	ideal
잠기다	Sink in water
주고받다	Give and receive, exchange
주먹	Fist
지지	support, backing
털다	To shake off, brush up
경고	Warning
공개하다	Open to the public
과목	A subject / a lesson
구경	An enjoyable sight / spectacle
그분	That person (respectful)
근무	Duty / service / work
논쟁	Controversy, argument
달아나다	Escape, flee
묶다	bind, tie
성명	A declaration, statement
소스	Sauce
수십	Tens of sth
신다	Put on, wear
우리말	Korean (language)
유교	Confucianism
이불	Bedding, bed clothes
이성	Reason, reasoning
일상	Everyday, usual, ordinary
자동	self-acting, self-moving, automatic
장래	The future
전개되다	To be unfolded, spread out
죄송하다	regret, be sorry for
중요성	importance, gravity
탤런트	Talent
특별히	Especially
품질	The quality of the article ( but not the article itself)
회견	An interview, a meeting
훔치다	To steal
흔적	traces, signs, evidences
고전	A classic in literature
과학적	Scientifically
구분하다	To divide / to classify
그럼	Certainly / of course.
뇌	Brains
봉투	Envelope
분명	Obviousness
사설	An editorial
승리	A victory
좌우	Left and right
주	main (f ex: main customer)
지다	to sink; to set (sun); to go down
추억	Memory
하여튼	Anyways
함부로	Indiscriminately, at random
향기	fragrance, aroma, perfume
현지	The actual place, the very spot
가늘다	Thin / fine / slender
개인적	Private / personal
겉	The outer surface
굽히다	Bend / stoop
근무하다	Work / labor
깜짝	With a surprise
넓히다	Widen
대	pair, vs.
떠들다	to make a noise
매년	Every year
발생	1. Birth 2. development
셋	Three
소주	Korean sake
손바닥	The palm
승용차	A passenger car
어색하다	To be awkward, shy with words, speechless
얹다	Put on, place, lay, set
의학	Medical science
장점	A merit, strong point
적당히	suitable, proper
줍다	Pick up, gather
진출	An advance
창조	Creation
킬로그램	Kilogram
평범하다	Plain, average
프로	program
홍보	Public information, public relations
확인	A check, confirmation
가루	Powder / flour; meal
건지다	Take / bring out of the water / 2. rescue a person from danger
깨지다	To break
내다보다	Look out for
대량	A large quantity
동행	accompaniment, going together
들	meadow, field, plain
떼	group
마땅하다	Be right, approppriate
바로잡다	Straighten
박히다	Be nailed in
방금	Just now
생선	Raw fish
슬픔	Sorrow
아무렇다	unspecific, careless
이용되다	To be used
이튿날	The second day after
임시	Temporary, special
제거하다	exclusion, removal
줄다	Diminish
지구	district, zone, region
지우다	To erase
참기름	Sesame oil
통	barrel, bucket, cask, pail, vat
특수	characteristic, distinct, unique
팬	Pan
합치다	combine, unite
호기심	Curiousity
골목	A side street / alley
기운	Strength / might (the strength you feel you have on that particular day)
기획	Planning
대충	Almost, nearly, about
돌아서다	to turn around (while standing)
동화	fairy tale
두껍다	to be thick
맞서다	Stand opposite
모자라다	To be insufficient
박다	Drive, hammer in
본성	Original nature / character
상상하다	Imagine
생산력	Productive capacity
셋째	The third
안전하다	To be safe
유학	Studying abroad
이르다	to say, tell
장비	equipment, fittings
정치인	Politician
정치적	Political
졸업	Graduation
처벌	punishment, penalty
카페	Cafe (place to drink coffee)
콤플렉스	Complex
검토	An examination / investigation / study
그다음	Next
기법	Techniques
끓다	Boil / simmer
날아오다	Come flying
농담	A joke
닭	Chicken
담임	Charge, duty
도중	On the way
두드러지다	(to be) remarkable, prominent, noticeable
맥주	Beer
모래	Sand
살아남다	Survive
살인	Murder
성질	naure, disposition
신호	A signal, signaling
아버님	Father (respectful word)
의심하다	To be suspicious, to doubt
인	A person
잇따르다	Follow one after another
자랑하다	To be proud
자판	Keyboard
적용	Application
전기	first period, early years
중반	At the middle stage (of a game / contest, / otherwise)
지시하다	To direct, instruct
출발	To start (a journey, trip)
허용하다	To permit, approve, grant, allow
가르침	Teaching / an instruction
각국	Each country
교과서	Textbook
그려지다	Draw
꾸준히	Untiringly, ceaselessly
년도	year (administrative, fiscal, school, etc.)
다수	A great number
덕분	Indebtedness
돼지	pig, swine
두드리다	to knock, to tap, to beat, to rap
무리	Be unreasonable
물음	A question
빌다	pray, wish, ask
수영	Swimming
스님	A priest
썩다	Go bad, rot
어머님	Mother (respectful word)
엉뚱하다	Be extraordinary, extravagant; to misdirect somebody's attention
여보	Spouse (term of affection)
잊어버리다	To forget
정면	The front, the facade
조각	Sculpture
태우다	Burn, commit to flames
해석	Interpretation, a comment
가리다	to hide, to cover, to obscure, to block from view
개국	The foundation of a country
계산하다	To calculate
근원	The origin / root / source
기차	A train
담그다	Soak in water
마음대로	As you wish
며느리	Daughter-in-law
믿음	Belief
발견	Discovery
보고	report, information
부탁하다	Ask sb a favor
사용자	A user, consumer, employer
사회주의	Socialism
설치되다	To be established
수도권	The Metropolitan area
식탁	Dinner table
실패하다	To fail
영원하다	To be eternal
우연히	accidentally, by chance
자극	A stimulus
정해지다	To be determined, settled
짚다	Feel, examine
총리	General overseeing, presiding over
칭찬	Praide, admiration
튼튼하다	Solid, compact, firm
햇빛	Sunshine, sunlight
공원	Park
긍정적	Affirmation / admission
논의하다	Discussion
대출	Lending
덕	Virtue, morality
돌보다	to care for; to take care of
뒤집다	to flip (an object, such as a pancake on a hot skillet)
먼지	Dust
바닷가	The beach
바치다	Give, offer
반하다	To be contrary to
발표되다	Be announced
부정하다	Be uncertain, irregular
불러일으키다	rouse, stir up
사원	Company employee
소유자	Possessor
씹다	To chew
아무튼	In any case
안되다	cannot; Must not, should not
액수	A sum, an amount
왠지	I don't know why, there is no reason for it
욕심	Greed, selfishness
우승	First place
익다	Ripe, be ripe; to be skilled, to be experienced, to be familiar
제출하다	To submit, tender
조심스럽다	Cautious
직전	Just immediately before
짐작하다	To guess, infer
택하다	Choose, select
피시	PC, personal computer
흘러나오다	Flow out, run, effuse
가구	Family
간단히	Simply speaking
강물	River water
거꾸로	Backwards / bottom up / the wrong way
궁극적	Finally / in the end, 마지막으로
극히	Exceedingly / extremely
기여하다	Contribute / add much to
꼭	grasping tightly, firmly; holding back resolutely (e.g., tears)
날짜	Date
대륙	A continent
되게	very, extremely, terribly, awfully
뒤따르다	to follow, to go after
리듬	rhythm
모니터	Monitor
범인	A criminal
변동	Change, flucutation
불가피하다	Inevitable, unavoidable
삶다	boil, cook (eggs)
샌드위치	Sandwich
서류	documents, papers
손해	damage, injury
숨지다	Breathe one's last breath
아유	Good heavens!
요청	request, demand, claim
운	Fortune, luck, fate
일상생활	Everyday (daily) life
자존심	self-respect; self-esteem
주저앉다	Sit down, plump down
증권사	Securities corporation
진하다	Be dark, deep
초원	A plain, a prarie
최종	last, final, terminal
회복하다	To recover, get better, get well again
흘러가다	flow, run, drift along
흥미	interest, zeal
검사	public prosecutor
그쪽	Those people
꾸다	to dream
내려다보다	Overlook
눈썹	The eyebrow
대신하다	Relieve, replace another
두렵다	to be fearful, to be scared
등장	appearance (e.g. on stage)
디자인	design
마디	A word, a tune, a song, a paragraph
미처	To that extent
비닐	a thin sheet of plastic, vinyl
비율	ratio, percentage
생물	A living thing
소음	A noise, cacaphony
양국	Both countries
얼핏	at a momentary glance / intermittently appearing (e.g. catch a fleeting glimpse of)
오래되다	To last for a long time
웬	What sort of, what kind of
중부	The center, middle part
차	tea
채소	vegetables, greens
침	Spit
털	Hair; fur, feathers
판매하다	To sell
항의	A protest
해당	Come/fall under the purview of
확보	security, insurance
환경오염	Environmental pollution
가치관	one's values / sense of values, a value system
검은색	Black / dark
고생하다	To suffer / to have trials; to do something you don't want to do, 하고 싶자 않은 것
기원전	B.C.
기타	The others / the rest
긴급	Emergency
꺾다	Break off / snap off
꿈꾸다	To dream
무려	As many as, no less than
묻히다	Get buried
수표	A check
실태	The actual conditions, reality
아쉽다	To miss, feel the loss of
애정	Love for a person, affection
얘	Sonny, you there
어머	Oh my god!
여보세요	Telephone HELLO
일정	To be fixed, settled, regular
장르	Genre
저렇다	Such a thing as that
접하다	adjoin, be adjacent to
정성	True heart, devotion
제약	A condition, restriction
쫓다	Drive away, chase off
천	thousand
추가	An addition
테이프	Tape
품	Width; bosom, breast (the clothes have a big ~)
확인되다	To be confirmed
가하다	To add
간장	Soy sauce
강의	A lecture / discourse
고민하다	Be in anguish / worried
과	a section / a academic department
교환	An exchange
국어	1. The national language / 2. Korean
노랗다	Be yellow
다치다	To hurt
동양	the Orient, the East
동포	compatriot, countryman
뚫다	to pierce a hole through, to bore through
상	Upper
새	Contraction of 사이 (sai, “gap; space between”
악기	Musical instrument
연말	The end, close of the year
올려놓다	Put a thing on a place
외면하다	Outward appearance
원고	A manuscript
정말	Really
줄곧	All the time, all through, repeatedly, constantly
지출	Expenses, expenditure
차	difference; to distinguish
치우다	Straighten up, tidy, remove
피로	Fatigue, exhaustion
향	perfume, incense
개선하다	To renovate / to improve
계좌	Account
당기다	Pull
도	(government) province (in both Koreas); principle, reason; morals; (philosophy, Confucianism) the Way, the Tao
들다	Means continuing the main verb's action; to enter/go into; to hold, to carry
따르다	to pour
말기	The end, final period
말없이	At a loss for words
망하다	Go to ruin
문서	A document
박수	Applause
부자	A rich person
사흘	Three days
서쪽	The west
성립되다	To be concluded, formed
손자	Grandson
신랑	A bridegroom
실습	Actual training, practice
일찍이	Early
자율	self-control, autonomy
제법	quite, fairly, considerably
집중되다	To concentrate
창조적	Creatively
천장	The ceiling
파다	To dig
하긴	Indeed, though, nevertheless
해결되다	To be settled, resolved
향상	Improve; elevation, rise
화가	A painter, a drawer artist
가라앉다	To sink (calm, settle, subside)
감싸다	1. wrap up / tuck in 2. to protect / defend
고작	To be at the highest / the best
구경하다	To watch / enjoy watching
국물	soup / broth / gravy
기구	device; tool
깔다	to pave (a road), lay down a floor, spread a blanket etc.
다짐하다	Pledge, vow, swear
대합실	A waiting room
말씀드리다	Speak (honor.)
매장	A store, shop
멀어지다	Become distant to
명칭	A name, title
불쌍하다	To be deplorable
상업	commerce, trade
생산되다	To be produced
숨기다	To hide
실력	one's real ability, talent
야채	Vegetables
엉덩이	The buttocks
울음	crying, weeping
이달	This month
인체	The human body
저고리	A coat, korean jacket
전부	All, everything
즐거움	pleasure, merriment
지다	to be defeated; to lose
진단	Diagnosis
질병	A disease, sickness
짜다	to make, to assemble, to put together, to piece together
체력	Physical strength
친하다	To be intimate, familiar, close, friendly
헤아리다	Consider, weigh, ponder, consider
각기	Each / severally / respectively
경찰서	A police station
곧바로	At once / straight away
관찰	Observation / survey
구두	Shoes / boots
군사	soldier
귀신	A ghost
귀하다	1. noble / high 2. dear 3) lovable / precious
그토록	So much / to such an extent
기초하다	Make the basis for
나뭇가지	A tree branch
낫다	to recover from an illness
답하다	Answer, reply
대가	A price, cost, charge, consideration, purchase money, value
더위	The heat
되찾다	to retrieve, to find (something again)
말리다	Dry sth
무덤	A grave, tomb
물결	A wave
밥상	Dinner table
보장하다	To secure, guarantee
사과	An apple
사귀다	Make friends with
서너	About three, three / four
솟다	rise, soar, tower above
실패	Failure
예상하다	To expect, anticipate
예외	An exception
완전	Perfection, completeness
웃기다	To be funny
유리	A glass pane
절대적	absolute, unconditional
제작하다	To produce, manufacture
쥐	Mouse
최대한	At the most, at the maximum
턱	The chin
팔리다	To be in demand, to be sold
품다	To hold, embrace
하하	Ha ha ha ha ha
형부	A husband of a girl's older sister
휴식	Rest, take a rest
굳다	Harden / become hard
굳어지다	Become hard
굶다	To starve / go hungry
금년	This year
기기13	Machinery and tools
까맣다	Black
나침반	A compass
농부	A farmer
대학원	Graduate school
더럽다	Foul, dirty
도달하다	Arrival
뒤늦다	late, tardy
뒤지다	to rummage, to rifle
등록	registration, enrollment
디스크	disk
맛보다	Taste
무늬	Pattern
문장	writing, composition
묻다	to bury
변호사	Lawyer
상	statue; figure; image
상상력	Imaginative powers
여학생	Female student
영업	business, doing business
예방	Prevention, protection
완성	completion, accomplishment
유리하다	To be profitable, favorable
자연환경	Natural surroundings
증명하다	To prove, show, bear
지적되다	To be pointed out to
지점	point on a map, spot, place, location
철저히	Thoroughly
코스	Course
학부모	Mothers of the students
합리적	Rational, reasonable
해석하다	To intrepret, construe
힘쓰다	To try really hard
거듭	Again / over and over
귀국하다	To return to one's home country
기뻐하다	Be pleased / delighted with
날리다	To send flying
내려놓다	Set / put down
냉장고	Freezer
당근	A carrot
덜다	Save, lighten
뛰어넘다	(transitive) to leap, to jump (over something)
마누라	one's wife
맞이하다	Go to greet
불행하다	Do not permit
신고하다	To state, declare
연속	continuity, succession
외롭다	To be lonely, lonesome
욕	An insult
원장	The chief/head (of a 학원)
유물	A relic, cultural remains
저절로	Of itself, on its own accord
절	bow; greeting
정비	maintaining equipment in good working order
주의	attention, notice
지난번	Last time
집어넣다	Put in
통계	Statistics
파일	File
판	A match, game, contest
피해자	A sufferer, the injured party
필수적	necessary, indispensable
학용품	School things, supplies
화분	Flower pot
환하다	To be clear, unobstructed; to be light, bright (opp. 어둡다)
갈색	Brown
감기	A cold
강남	South of a river
구속되다	To be arrested
돌아다니다	to get around, to go around, to wander, to roam
등등	et cetera
멋지다	Be splendid
반발	Repulsion, a backlash
반찬	Sie dishes
방지	Prevention, check
배다	Soak into
보장	guarantee, security
빠져나오다	Come out of somewhere
새다	leak, escape from
소개되다	To be introduced, presented
씨	seed, kernel
안쪽	The inside, the inner part
억울하다	To be regrettable, disappointing
오가다	Come and go, keep going and coming
요구되다	To be requested, claimed
음성	A voice
이윽고	After a while, shortly
장식	Decoration
전개하다	To unfold, evolve, spread out
전날	The day before, the day prior
전반적	over-all, all
척하다	The preceding verb is a lie
풍습	customs, manners, practices; a ritual, rituals
한가운데	The very middle, the center
한정되다	To be limiited, qualified
해내다	To accomplish, achieve, carry through
흉내	Imitation, mimicry
감옥	Prison
갚다	Pay back a loan
건전하다	Health / soundness / vitality
결혼식	Wedding
계산기	Calculator
광장	An open space / a plaza / public square
그렇지	So it is / that is right
깨다	to break; to smash; to shatter, to crack
꽉	Tightly / fast
끼우다	To put between / insert
노래하다	To sing
다듬다	Trim, shave
다름없다	Be similar, not different
당당하다	Dignified
댐	Dam
덩어리	A lump, a cluster
두뇌	brain
등	신체의일부
모처럼	At long last
물리학	Physics
벌	Punishment
부정적	negative, contradicting sth else, not positive
북부	The north part
분리	separation, segration
상당	proper, fit, suitable
세다	To be strong, mighty
소개	Introduction
수화기	Telephone receiver
애인	A lover
애초	The first, the beginning
얇다	To be thin
양념	Spices and condiments
에	at/in/on
오염되다	To be polluted, contaminated
오해	Misunderstanding
웬일	What cause, what reason
의식	A ceremony
의지하다	To look to, depend on, rely on
일기	A diary, journal
절대	Absoluteness
제한하다	To restrict, limit
존중하다	appreciate, esteem, value
창고	A warehouse, storehouse
책임지다	Take responsibility
청춘	youth, the springtime of life
초반	The opening part (of a game of baduk)
트럭	Truck
파	Onions
폭넓다	To be broad
표현되다	To have been expressed
학번	Year of graduation
학원	Learning institute
허가	Permission, grant, leave
헤매다	Wander about, roam about
가장	head of a family
곡	A tune / an air
곡식	Cereals / grain
꽂다	Be stuck in / insert
두려움	fear, terror
망설이다	Hesitate
무리	group, crowd, gang, horde
버터	Butter
별다르다	Be of a peculiar kind
보편적	Universal
부품	Parts, accessories
뻔하다	almost, nearly
뽑히다	Be taken out, pulled out
상담	Consultation
서부	The western part
속담	A proverb, saying
시중	In the city
심사	judgment, examination
앞세우다	Make a person go
유사하다	To be similar, to resemble
유치원	Kindergarten
의욕	volition, will, desire
인근	The neighborhood
일반인	Of the general public
작성하다	To edit / compose, write up; to fill out a form
전공	Specialty
정기	A fixed time period
제의	A proposal, an offer
종일	All day, throughout the whole day
좋아지다	To become better
차림	Appearance of clothes / worn objecs
창조하다	Create
추위	Cold
토마토	Tomato
파랗다	To be blue
펴내다	Publish, bring out in print
하드웨어	Hardwaer
화장	Makeup
가져가다	To take / carry
감자	Potato
강렬하다	Intense / strong / severe
갖다	To hold
괴롭다	Be painful / distressing
교통사고	Traffic accident
군데	A place / spot
되풀이하다	repeat (do / say again)
딱	(onomatopoeia, of solid objects) while colliding together
리	village; a Korean administrative division covering a small settlement and its surrounding hinterland.
메시지	Message
면하다	escape, avoid
모색하다	Evening twilight
붙잡다	seize, catch
빛깔	A color, shade, hue
뺨	Cheek
사방	The four directions
살림	living, livelihood
실현	realization, materialization
아냐	No, that's not the case
연예인	A performer, an entertainer
영원히	Forever
월급	Monthly salary
유행	Fashion, vogue
이내	soon, right away
이리	This way, this direction
제발	kindly, please
차츰	gradually, step by step
투표	vote, voting
파괴하다	Destruction, demolition
하느님	God
해당되다	correspond to, be equivalent to, be tantamount to
홀로	Alone, by oneself
가득하다	To fill
각자	Each one / every one
감히	Daringly / boldly
강요하다	to force, to impose
개미	Ant
관습	Custom / usage
광경	A spectacle / a sight in 3-d and uncut (compare 관광 tourism)
금세	In a moment / at once
낮추다	Lower, make low
내주다	Take out and give away
명의	name, title
물고기	Fish
물러나다	Fall back, to pull back, to pull back your position
밀접하다	Be close, intimate with
부탁	request, favor
분량	quantity, measure
불과	Only, not more than
상자	A box, case
새해	A new year
소박하다	simple, naive, ingenuous
수없이	Be unable to do
승진	promotion, advancement
양	two; both
얼음	Ice
열매	Fruit
적히다	To be recorded, written down
점수	marks, the number of marks
제한되다	To be restricted, limited
지속되다	Be lasting a long time, be continous
쫓기다	To be chased, be driven
쭉	All the time
통장	A bankbook (check register)
평가되다	To be appraised
하도	Too much, excessively
한창	The height, summit, the top
해안	The seashore, the coast
호박	Pumpkin
흑인	A black person
간	liver
갇히다	Be confined / shut up
결심하다	To resolve / be determined
경기장	Sports stadium / a sports field
고장	breakdown (mechanical)
근로	Labor / exertion
눈동자	The pupil
닥치다	Shut the mouth!
도시락	Lunchbox lunch
뜯다	to tear, pick, pluck
몸짓	A gesture
부담하다	bear, shoulder a responsibility
부회장	A vice president
빼앗다	Snatch, take away from
삼키다	Swallow
성실하다	Be ripe
스튜디오	Studio
요새	recently, lately
이상적	Abnormal
일쑤	Habitual practice
일체	All, everything, the whole
자꾸만	Repeatedly (emphasized)
잦다	Be frequent, incessant
절망	despair, hopelessness
접다	Fold up
제시되다	To be presented
주방	A kitchen, a cookroom
진출하다	Penetrate into, advance
짜증	Annoyance
첫날	The first day
통과하다	Passage through
투명하다	To be transparent, clear
확산되다	To get diffused
경력	one's personal history
고통스럽다	Be painful / torment
곤란하다	Difficulty / trouble
공중	The air / the sky
공해	Environmental pollution
귀찮다	Annoying irksome
기대다	1. To rely upon / lean upon 2. lean against
깨어나다	Return to consciousness
꼽히다	To be elected
대다수	A large majority
듯싶다	To be like something, i guess
먹이	Food
무	Radish, daikon
무료	Free, without charge
밉다	Be detestable
발레	Ballet
상징하다	Symbolize
실현하다	To realize, bring to fruition
아깝다	regrettable, pitiful
안정되다	To be stable
어리석다	juvenile, foolish
엎드리다	Prostrate oneself, lie on the ground
여럿	many, many people
연설	A public speech
연필	Pencil
염려	anxiety, worry
우습다	To be funny, amusing
운전	Driving
익숙하다	To become accustomed to
일자	A date, the number of days
잔치	banquet, feast
전달되다	To be delivered
차다	to be cold to the touch
치료하다	To cure, heal, treat a patient
칸	Blank space
한	deep-seated resentment
갈수록	As one goes aong
갖가지	A variety of / all sorts
거절하다	Refuse / reject
관광객	A tourist
구별하다	To distinguish between A and B
국	Soup / broth
다행	Good luck
동의	agreement, consent
마무리	Finish, completion
마주치다	Collide with
막상	Really, actually
몸통	The trunk, body
못	nail; peg; spike
묘사하다	To describe
미술관	Fine arts museum
베다	Cut, chop
보장되다	Be secured
볼	Cheek
부분적	Departmental
불고기	Roast meat
불리다	soak, sodden
불행	Unhappiness
비명	A scream
순수	purity, genuineness
시각	time; a specific point in time
실질적	substantial, essential
안개	Fog
여름철	Summertime
오로지	Only, solely, exclusively
완성하다	To accomplish, to end successfully
이런저런	This and that, one and another
임무	A duty, an office, a task
자연히	Naturally
장난	A game, playing
저런	Such a, that sort of
전용	Exclusive / private use
지극히	very, extremely
청하다	ask, request
확정	decision, settlement
가상	Imagination
간혹	Occasionally / at times
개방하다	To open / to throw open
관계되다	Be affected / influenced by
국산	A country's product
그해	That year
꺼지다	To go / die out
꼭대기	The top
끊어지다	To break off / expire / be done with
도	path, travels, way
리그	league
마이크	Mike
만족하다	To be content
메우다	To carry, attach; put on
면적	area, dimensions
목욕	A bath
반성	Reflection
벌떡	Suddenly, abruptly
보상	Compensation
분리되다	To be segregated
빚	Debt
새기다	To sculpt, engrave
서민	Common people
석	A seat, sitting place
선정하다	select, choose
세다	to count
소수	A small number, a few
쇼	Show
수학	Mathematics
시어머니	one's husband's mother
시집	one's husband's home/family
연간	For a year
영화제	Movie festival
예측하다	To predict, forecast
용도	use, service
의심	A doubt
이동하다	To move, migrate, travel
자극하다	To stimulate
재빨리	quickly, rapidly
적합하다	suitability, fitness
전화번호	Telephone number
조절하다	To regulate, tune
조정	regulation, control, coordination
중얼거리다	Mutter to oneself
지급하다	To pay, allow, furnish sth
확장	expansion, enlargement
힘차다	Be forcible, powerful
감사하다	To thank
건조	Dryness / aridity
고요하다	Be quiet / silent / still
그대	You / thou
그립다	Beloved / sweet / affectionate
긋다	1. draw / mark 2. strike
기둥	A pillar
긴장하다	To become tense
날카롭다	Sharp
논하다	Argue, discuss, debate
느리다	Be slow, tardy
도덕	Immorality
동부	the eastern part; east
뒷모습	The features of the back side
똑똑하다	(to be) smart, clever, intelligent
만	ten thousand
만만하다	Be soft, tender; to be easy to handle, deal with
못되다	To go wrong
보고하다	Report to a person
사무소	Office
사촌	a cousin
상	prize; award; reward
상인	merchant, trader
선언하다	declare, proclaim, announce
소원	one's desire
수입하다	To import
식다	To get cold, cool off
엿보다	Wait for an opportunity
완성되다	To be accomplished
유적	Remains, relics, ruins
일생	one's lifetime
입히다	Clothe, dress
잡아먹다	Slaughter and eat
정보화	Change to an information orientation
종종	A variety of things
지갑	A purse, wallet
차다	to put on, to wear, to don, to hang on one's body
창작	Creation, origination
축소	Reduction, a cutback
취향	Taste, liking, one's inclinations
친절하다	To be kind, to be nice
카운터	Counter, where you pay
탄생하다	To be born
하숙집	Dormitory, boarding house
학급	A class (school)
해군	The navy
효율적	The utility factor, efficiency
가슴속	one's heart feelings
간	salty seasonings
간판	A signboard
건드리다	1. touch / jog 2. irritate / vex
관리하다	To manage / control / supervise / manage
괴로움	Trouble / annoyance / distress
근거하다	To base sth on sth
금액	Amount ofmoney
다행히	Fortunately
달래다	Calm down
동아리	(school) club/circle
따라오다	to follow, to come after
말리다	to stop, to keep
맘	mind, heart (i.e. one's emotions); intention, will
먹다	to make up (one's mind), to be determined
명절	Festival days
바이올린	Violin
밝혀내다	To find out
부서지다	Break, be broken
비행	Flying, aviation
상관없다	To not be of concern
성립하다	To exist, to come into being
수명	Life span
시즌	Season
신기하다	to be strange and amazing; to be mysterious, to be wondrous
업다	To carry on one's back, to shoulder sth
예감	A presentiment, a premonition
음식물	Anything to eat / drink
자신감	Self-confidence
죄인	A criminal
주의하다	Pay attention to
준비물	Stuff that needs to be prepared
천	Cloth, woven stuff
출입	Coming and going
쾌감	A pleasant sensation, a good feeling
탄생	Birth
튀다	Spring, bound, jump
하필	Why necessarily? Why of all things?
활용	Practical use
회색	Gray
거액	A large sum of money
고교	High school
고집하다	To be stubborn / persistent
곧잘	1. fairly / pretty well 2. frequently / too often
골짜기	A valley / gorge
교훈	Edification / giving instructions to
구르다	Roll over
글씨	1. Handwriting 2. a letter / an ideograph / a character
노래방	Singing room
단편	A piece, fragment
달다	to charge (money)
대처하다	Disposal, treatment
매다	Tie
머리카락	Headhair
명확하다	clear, precise
발걸음	Gait, step
발길	A kick; walking pace, steps
벌레	A bug
빼앗기다	A thing be taken away
생산자	A producer
선진	seniority, advance
성인	An adult
소매	1.a sleeve 2. a retail sale
시멘트	Cement
신규	A new regulation, a new project, sth new on a big scale; work being done anew
신청하다	To apply (for)
실은	In reality, to tell the truth
심판	referencing, umpireship
안기다	to be embraced by sb (in their arms)
양심	Conscience
이사장	A director
이자	Interest
익숙해지다	To become accustomed to
자세하다	Be detailed
저거	That thing over there
저축	savings, saving
제비	A swallow
제안	A proposal, suggestion
제안하다	To propose, make a suggestion
증세	Symptoms, a patient's condition
지난날	Old days, old times
진급	Promotion
콩나물	Bean soup
튀어나오다	Jump out, spring out
표준	A standard, norm, criteria
항구	A port, a harbor
허용	Permission, allowance
헬기	Helicopter
간신히	Narrowly / barely. 겨우
갈아입다	Change one's clothes
감다	to wind around, to coil
같이하다	To do together / to share
거짓	Fabrication / fiction
거품	Bubble
걸어오다	Come on foot / walk
공군	The air force
기술자	Technician
나물	Herbs, wild greens
년생80	Year of birth
달리기	A run, a spin
대도시	Large city
도둑	A thief, a burglar
도전	Challenge, defiance
면	(government) township
모자	A hat
보조	assistance, aid
불리하다	to be disadvantageous, unfavorable to/for
불편	Inconvenience
비비다	rub, chafe
사과	apology
살아나다	revive, be brought back to life
소파	Sofa
속이다	deceive, cheat
수면	sleep, slumber
수천	Thousands
스무	20
승부	A contest, match
시기	period of time, season
신념	belief, faith
신입생	A new student
어린아이	A youngster, a child
어쩐지	1. somehow, in a strange way; 2. in combination with an ending giving a reason to place stress on the action of the verb
여간	just, a little. 여간 ~지 않다 means very very ~다
역	(railway, subway) station
연락하다	To contact, get in touch with
영향력	Influence, power to influence
예의	Courtesy, politeness
이내	within (in less than)
이리저리	This way and that, here and there
인간적	Personal
인사하다	To greet, say hello
잘나다	To be handsome, excellent
재능	talent, ability
지불하다	To pay
파출소	Small, local police box
판	board, plank
한문	Chinese writing, chinese classics
건네주다	To pass over / to put on the other side (of a river)
결승	The decision of the final round of a contest
공공	The public / the common
교양	Culture / education
국왕	A king / a monarch
규칙적	Be regular / systematic
극복	Conquest / subjugation
글쎄요	Now / well / let me see
내려지다	To become lower
냉동	Refrigeration
녹다	To melt
배추	Chinese cabbage
센터	Center
수염	Beard
수집하다	To collect
승객	Passenger
싱싱하다	Be fresh, full of life
아아	Oh-oh!
어리다	tears come to eyes
여권	A passport
열쇠	Lock
오렌지	Orange
외모	Outward appearance
인공	Art, human skill
잠자리	Bed
장남	The eldest son
저마다	Each one, everyone
전국적	National
전반	The whole, all, general
제자리	The proper/original place
지루하다	Be tedious
척	A few ships (vessels)
포도주	Grape wine
학술	Science, learning, scolarship
혈액	Blood
화살	An arrow
화재	A fire, a blaze
가르다	1. split / divide 2. distribute / share 3) distinguish / separate
간격	A space / interval
고함	A shout / yell
공격하다	To attack
그놈	That person / that guy
기록되다	To be recorded / written down
끝없다	Endless / unfathomable
끼어들다	Interrupt
노선	Route
답	Answer
대사	Speech, dialogue, lines of an actor
도망치다	To make an escape
독서	Reading
동	number of houses, buildings, etc.
동의하다	to agree
딱딱하다	hard, firm (resistant to pressure)
땅속	In the soil
벌금	A fine
복	luck, happiness
봉사	service, attendance
부서	one's post, duty
성	castle; fortress
소형	Small size
신인	A new man
악몽	Nightmare
안내	Guidance, conducting
앞뒤	Before and behind
언덕	A hill
열정	Passion
오페라	An opera
입맛	Appetite, taste, palate
재즈	Jazz
적응하다	Be suited to, adapted to
절대	absolutely, totally, never
접시	A plate, platter
제공	An offer
참가	participation, joining
체중	Body weight
추석	Korean thanksgiving
충돌	A collision, clash; discord
통로	A passage, a way, an aisle
포장	packing, wrapping
해소	Dissolution, disorganization
행해지다	be enacted, come into action
현관	The porch, the entrance
현대인	A modern person
혜택	A favor, benefit
호수	A lake
확	With a burst, great puff
건너가다	To cross / go over (river / street)
골고루	Evenly / among all indiscriminately
구석구석	Every nook and corner
그제서야	Then
껌	Gum
녹색	Green
등록증	registration card i.e: permanent resident card / alien registration card
막내	The lastborn
반복되다	To be repeated
발전	power generation
방해	An obstacle, hindrance
번호	A number
벼	A rice plant
본인	Person in question
상점	A shop, store
수백	Hundreds
실장	boss, president
쓸쓸하다	Be lonely, lonesome
악수	Handshake
애	(idiomatic) anxiety; impatience
어지럽다	To be dizzy 2. to be in chaos, disorganized
어찌하다	Be subject to an attack of vertigo (figuratively), to not know what the hell is going on / what to do.
예정되다	Make a program, set a schedule
이중	duplication, double
인원	The number of persons
인정받다	To receive recognition
인터뷰	Interview
입학하다	To enter/be admitted into a school
자랑	Pride
저것	That thing over there
정문	The front gate, main entrance
착각	Hallucination, illusion
창	Window
친정	A woman's maiden home and family
켜지다	To become turned on
타입	Type
팩	Pack
표시하다	To make a sign, display
행하다	To do, act, behave
활짝	extensively, widely
감상하다	To show appreciation
개별	An individual / a particular case
공식적	Formal / procedural
그런대로	Such as it is / anyways
기독교	Christianity
깨달음	Realization
끼다	(of fog, smoke, etc.) to shroud, to envelop, to permeate
넘어지다	Fall down, collapse
눈부시다	To be dazzling
단점	A weak point
들려주다	let [sb] hear; tell, inform
뚜껑	lid
마음먹다	Be determined to
목록	Catalogue
반복하다	To repeat
반성하다	Examine oneself
별명	nickname, alias
보전	ingegrity, preservation
불어오다	Call to come
소유하다	To possess, hold
수박	Watermelon
스위치	Switch
신세	indebtedness, obligation
알아내다	To find out (e.g. the answer)
암	Cancer
야단	A clamro, uproar 2. a scolding
엔	Yen (japanese)
연결	Connection, linking
연관	a connection, a grouping together, relationships
용서하다	To pardon, to forgive
우정	Feeling of friendship
육군	The army
음식점	Restaurant
의논하다	To consult, confer with, talk over a matter
인분	How many people counter for at restaurants
주요하다	To be chief, principal, leading
죽	Rice porridge
차마	For all the world
참조	reference, comparison
타고나다	Be born, gifted/endowed with
태우다	to give a ride/lift
행사	use; exercise
향수	A perfume
허용되다	To be permitted, approved
가입	joining, signing, subscription
가정	a supposition / presupposition, hypothesis
과자	A snack / pastries / candy
교체	Shift / change / alternate
김	Seaweed, laver
꼬마	A dwarf
끝없이	Boundlessly
나르다	to move a long / semi-long distance (not just within a room); Carry, convey, transport
놀리다	Banter, tease
늘어놓다	1. Scatter about haphazardly; 2. 으로 늘어놓다 to arrange, place in order
닫히다	To shut, be closed
대표하다	Represent
대학교	University
돼지고기	pork
두려워하다	be afraid of, be scared, be frightened
뜻밖	unexpectedness, surprise
막걸리	A slightly bitter soju drink
맡다	(transitive) to smell
미스	Miss
밀리다	to be left undone, to be late in making a payment (to fall into arrears) 2. to be pushed, shoved
밥그릇	A rice bown
방문	door of a room
병들다	Get sick
부러지다	Break, get broken
불꽃	flame, blaze, spark
상대성	Relativity
설문	questions like those on a questionnaire
소설가	Novelist
쓸다	brush, sweep perhaps lightly
안녕히	Peacefully
안팎	The interior and exterior, both sides
예방하다	To protect, prevent, fend off
유의하다	To bear in mind, be heedful of
유학	Confucianism
이해되다	To be understood
인하	reduction, lowering
작성	editing, composition; filling out a form
잘리다	Be snapped, broken, cut off
전달	Delivery
전시회	An exhibition, show, display
전화하다	To call
전환하다	To exchange, to convert, to change over
정치학	Political science
좌석	A seat
주문	An order, a request
집안일	Housework
체계적	Systematic, organizational
출근	Going to work
크림	Cream
탁월하다	Be excellent, prominished
텅	Hollow
토하다	To vomit
푹	Completely, entirely
한순간	One fleeting moment
가사	Words / lyrics
가입자	Member / subscriber
감소하다	To reduce / diminish
개구리	Frog
결과적	Resultative
괴롭히다	Afflict / worry
구별	A distinction / a separation
깨우다	To wake up / awaken
끈	A string / a cord
끊기다	To be cut off / severed
끊임없다	To not end
넉넉하다	To be enough
동전	coin
두어	About two, a couple
마약	A drug
밑바닥	The bottom, base
보도되다	To be reported
보리	Barley
본부	The headquarters
부	wealth
성숙하다	to ripen, to mature
소극적	Passivity, passiveness
소용	use, usefulness
손질하다	Handle with care
수건	Handkerchief
순식간	A brief instant
시도	An attempt, test
시집	collection of poems
아무개	Mr. so-and-so
약점	A weak point, a vulnerable point
양복	Western European style clothing
어째서	For what reason, why is that
얼다	Freeze, be frozen
녀	A woman, a girl
연령	Age, years of age
예비	Preparation, reserve
울음소리	Sound of crying
이놈	That rascal!
이력서	Curriculum vitae, a resume (for a job)
인정되다	To be recognized
잠자다	Fall asleep
젓가락	A pair of chopsticks
주년	One whole year
중단하다	To interrupt, to stop
중대하다	importance, gravity
중심지	A central place
집중적	Related to the concentration
참되다	To be true, honest, faithful
초청	An invitation
출판사	A publishing company
탁자	A table, desk
토끼	A rabbit
퍽	Very, very much
풍속	Manners, customs, morals
피아노	Pian
핑계	Excuse
한층	More, still more
행운	Good luck, good fortune
가로막다	Interrupt / obstruct
간섭	Interfere / meddle
갈증	Thirst
갑작스럽다	All of a sudden
교환하다	To exchange
그래야	And so / and then
기원	Origin
길가	The roadside
난리	A war, revolt
남매	Brother and sister
내버리다	Throw away
달리하다	differ
뛰어가다	(intransitive) to run, to rush, to dash, to dart
미사일	Missile
발가락	A toe
보존	Preservation
보호되다	To be protected
뵙다	see, meet
부치다	to send, to post
상관	Concern, relation
설명되다	To be explained
섭섭하다	Be sorry, disappointed
세	world; lineage; generation
세련되다	To be polished, refined
손쉽다	Be easy, simple
안주	Appetizers for alcohol
어린애	A youngster, a child
열기	Heat, hot air
옷차림	Dress, one's way of dressing
위로하다	To console, soothe somebody
이같이	Like this, like so
인형	A doll
일치	Agreement, accord
재생	revival, restoration to life
전철	An electric railway
찢어지다	To be torn, rent
철학자	Philosopher
축하하다	To Congratulate sb
컬러	Colour
통화	Conversation by telephone
특이하다	Be peculiar, special, unique
필연적	Necessity, necessary
하룻밤	One night, a single night
흘러내리다	Run (stream, pour) down
가짜	Fake
강도	Intensity / strength
곰	Bear
급히	Fast / quickly / in a hurry
기념	Commemoration
나아지다	Become better, be improved
넘어오다	Fall, come down
되돌리다	restore, turn back
띄우다	fly, let fly, launch
매너	Manner
민속	Folk-customs
버려지다	Take away, throw away to somewhere
빗물	Rainwater
사위	environment, surroundings
설날	New Year's Day
설득하다	Persuasion
손질	handling, care
손톱	Fingernail
식빵	Bread
아르바이트	Part time
외로움	Loneliness
외우다	Recite from memory
운전자	The driver
유리창	A window which uses glass
입대	Enlistment, enrollment
적성	Aptitude
전망하다	Have a view of, observe
집단적	Collectively (of people)
차이점	A point of difference
찬물	Cold water
철도	Railroad
총각	A bachelor, an unmarried man
캠페인	Campaign
태풍	Typhoon
한눈	A look, glampse, look
햇볕	Sunbeams, sunlight
홍수	A flood, inundation
가뭄	A drought
간접	Indirectness
강력히	With great strengh / or might
개선되다	To be renovated / to get improved
건네다	Speak to a person / address
게	A crab
결심	Determination / resolution
곧장	Directly / straightforwardly; to do something straight away
교직	The teaching profession
구속하다	To arrest / restrain
귀중하다	To be precious
긁다	Scratch / scrape
금지하다	To restrain / prohibit
기사	driver; chauffeur; engineer
기숙사	A hostel / residence hall
나뭇잎	Tree leaves
내쉬다	Exhale
넓어지다	Get wider
늘어지다	Be lengthened
단독	Independence, being independent, being singular
마음껏	As much as you want
몰려들다	Be driven into
미팅	Meeting
바	bar
바퀴	Wheel
발자국	Footprint
뱉다	Spit
벌어지다	To become separated, To become estranged. Differ
보너스	Bonus
산책	A walk, stroll
생기	animation, life
서적	books, publications
소화	Digestion
수험생	A student preparing for an examination
시끄럽다	To be noisy, boisterous
신세대	The new generation
어기다	Run counter to, go against
어때	What do you think?
엘리베이터	Elevator
연구원	Researcher
연애	Love, tender, passion
연휴	Consecutive holidays
요약하다	summary, condense, abridge
운동하다	To do exercise
월요일	Monday
위성	A satellite
의외로	unexpectedly, surprisingly
이모	A maternal aunt
자살	Suicide
제시	Presentation
제외되다	To be excluded
조카	Nephew
주소	An address
찍히다	Get sealed, stamped
철	Steel
취직	Employment, getting a job
타락	depravity, corruption, degradation
통화	currency
틀림없이	No mistaking it
파티	Party
회관	An assembly hall
계획하다	Plan / make a project
공연장	Auditorium
국적	Nationality / citizenship
근래	Of late / recently
나뉘다	Divide
낱말	A word
내외	inside and outside, home and abroad
냄비	A pot
늑대	Wolf
늘어서다	Stand in a row
다정하다	To be affectionate, warm-hearted
달다	to be sweet, to be delicious
달려들다	to rush in
망원경	Telescope
모범	model, example
무리하다	to overexert oneself
묶이다	Be fastened together
방해하다	Interrupt, interfere
뱀	Snake
벌	a set of clothes
뵈다	Contraction of 보이다; to show
상류	The upper classes, upstream
석	three
선명하다	To be clear, distinct
선호하다	To prefer
성공적	Successfully
소규모	Small scale
수시로	On demand, per the demand of the occasion; all the time, at any time
시야	Visual field
실현되다	be realized, be materialized
아니야	No, that's not the case
어느덧	Before one knows it
오르내리다	Go up and down, rise and fall
왕자	Prince
우수하다	to be superior, excellent
유명	fame, celebrity status
유형	A similar type
으레	customarily, habitually
일상적	Daily, of the everyday things
일일이	One by one, individually
전공하다	To major in something
전후	sequence, order, front and rear
정상	normality
정상적	normal, like usual
질적	Qualitative
척	pretense; as if
철	season (of the year)
청소하다	To clean
충격적	Shocking
치아	A tooth
판	board, game board
편의	Convenience, expediency
폐지	Abolition, to not use, to do away with
해설	Explanation, elucidation
헌	Old, shabby, worn-out
흑백	Black and white
희생	A sacrifice
가까워지다	Get closer
강도	burglar, thief
경비	Expenses / outlay
경제력	Economic power
금하다	1. suppress / restraint 2. abstain from / restrain from
기대되다	To be expected
깊숙이	Deep / far
꿀	Honey / nectar
넘어뜨리다	Throw down
농사짓다	To do farming
단단하다	Be hard, solid
담당자	Person in charge
답변	An answer
대비	Provision, preparation
대체	An outline, summary
더욱더	More and more and more
도심	The heart of the city
된장	fermented soybean paste
둘러싸이다	be wrapped, be surrounded, be enclosed, be encompassed
등산	hiking, climbing
마찰	Rubbing, chafing
마크	a company logo
만족	Satisfaction
망치다	Ruin
메뉴	Menu
모금	Money raising
묘사	Description
문화적	Cultural
묻히다	stain, smear
미혼	Unmarried
발전되다	Be advanced, prospering
방송사	Broadcasting company
방지하다	To prevent, check
사표	A written resignation
삼가다	Be discreet, take care of; to abstain (refrain) o.s. from doing
생방송	A live broadcast
소홀히	carelessly, indifferently, neglectfully
손발	Hand and foot; the limbs
쌍둥이	Twins
안내하다	To lead the way
앉히다	To place a person in a set
영하	Below zero
옆구리	The side, the flank
외교관	A diplomat
외국어	A foreign language; sometimes, only means English
웬만하다	To be just only barely passable, fairly good
유행하다	To be in fashion, to be popular
으응	Ugh!
이어서	Subsequently
자장면	Black chinese noodles
자정	Midnight
종합하다	synthesize, integrate
중학생	Middle school student
짜다	to press, to squeeze
참	break, rest, recess
최후	The last, the end, the conclusion
취재	Selection, picking out of news articles (by a reporter)
치다	to cast (a net)
테러	Terror
토론회	A debating society/contest
한잔	A drink of liquor
호주머니	A pocket
휴일	A day off of work, a holiday
가난	Poor
가죽	The skin / hide / leather
관계없이	Without any relation
군	county, a secondary administrative division of both North and South Korea
기다	Crawl / creep
다툼	A quarrel
달력	A calendar
대	Used to count long, stick-like objects, such as arrows, rib bones, and cigarettes.
대낮	Broad daylight
데려가다	Take with
도자기	Porcelain
돌멩이	(small) stone, rock
되돌아오다	come back, return, be restored
두께	thickness
뒤쪽	back, rear
모조리	One and all, wholly
변경	Change, alteration
부지런히	Diligently
사슴	Deer
삼촌	An uncle (usually on the father's side)(외삼촌 a brother of the wife, an uncle on the mother's side)
상당수	plenty/a lot of
소풍	Picnic
속옷	Underwear
손목	The wrist
손실	Loss
슬쩍	Secretly, on the sly, stealthily
시나리오	Scenario
신문지	Newspaper paper
실컷	To one's satisfaction
양보하다	To make a concession, recede
엔진	Engine
용	A dragon
운행	movement, revolution
이대로	As it is
인간성	Human nature
인상적	Impressive
자라나다	To grow up
전시	exhibition, display
조그마하다	Be tiny, small
주차장	Parking lot
주한	Residing in South Korea
중년	Middle-aged
지다	look [be] gloomy, have a gloomy expression (on the face)
찌꺼기	drugs, sediments, remnants (tea grounds)
춤추다	To dance
테니스	Tennis
파리	A fly
포스터	Poster
포함	inclusion, comprehension
형식적	Related to the form
호남	The HONAM district, which is CHOLLA-DO in S.W south korea
후회하다	To regret
가이드	Guide
가입하다	Join
감소	Decrease / dimunition
고르다	to be even, equal; to be straight (of teeth)
고속도로	Freeway / highway with no street lights
공책	Notebook for taking notes and studying
구분되다	To be put into sections
구입	Purchase / buying
기여	Contribution / service
기호	Taste / likes
꾸리다	Pack up / bundle up
낭비	Waste
대략	an outline, summary 2. generally, on the whole
덮이다	Be covered
도리어	On the contrary
똑바로	straight, upright
라인	line
렌즈	lens
멋있다	stylish, tasteful
멸치	Anchovy
바람	desire, expectation, hope
발목	Ankle
밤늦다	It is late at night
방울	A drop
배	pear
벌	bee, wasp, / hornet
보관	custody, deposit
보살피다	Take care of
보완하다	to supplement and make complete, to complement sth
보존하다	preserve, conserve
빨다	sip, suck
빼놓다	exclude, leave out
사상	In history
사춘기	adolescence, puberty
상반기	The first, upper half
서점	A bookstore
선전	Propaganda
설립하다	found, establish
수집	Collection
수필	An essay
신기하다	to be novel; to be new and interesting
신비	Mystery
신설	A new theory
실감	Actual feeling
실망	Disappointment
쓰다듬다	Stroke one's beard
알루미늄	Aluminum
알아주다	acknowledge, recognize, appreciate
양말	A sock
여우	Fox
와	Holy cow!
외출	Going out, an outing
용기	container
웨이터	Waiter
유발하다	To induce, bring about, cause
유지되다	To be maintained, preserved
자가용	For personal/family use
잡아당기다	Pull
점검	inspection, examination
정말	Real, true / genuine
정원	Garden
조기	An early stage, period
존경하다	Respect
종	bell (instrument)
종소리	The sound of a bell
중순	The second 10 days in a month
지각	perception, consciousness
직선	A straight line
참외	A melon
체하다	pretend, feign
체험하다	To experience, to undergo
초대하다	To invide
총	gun; rifle; machine gun
칭찬하다	To praise somebody
코치	Coach
통일하다	To unify, consolidate
패션	Fashion
프린터	Printer
피디	PD – a newspaper article
하나하나	Each individual piece
학위	Academic rank
회의	doubt; skepticism
가로등	A street light
감	Feelings
개개인	Individuals / every person
걷다	(of sleeves) to roll up
고집	Persistence / stubborness
금	Gold
급격히	Be rapid / sudden
기막히다	Be at a loss for words
나누어지다	To become divided
낙엽	Fallen dead leaves
넘겨주다	Hand over
논리적	Logical
다가서다	Step up, go near to, come closer
대기하다	Be ready for the opportunity
대접	treat; reception
동창	schoolmate, graduates of the same school
두리번거리다	look around
맞은편	The other side of x
멋	Smartness
면	cotton (both the fiber and the cloth)
박	Staying the night
밤하늘	Night sky
변명	Explanation, vindication
보자기	A diver
부상	A wound, injury
분리하다	To separate, break away from
붙들다	catch, seize, grasp
사들이다	buy, purchase
상관없이	Without anything to do with
새우	lobster, shrimp
선원	A crew, a ship's company
설사	Diarrhea
실망하다	To disappoint
심해지다	Become deep and serious
씨름	Wrestling
아쉬움	Sense of missing
앞길	The road ahead, outlook
약해지다	To become weak
어젯밤	Last night
엉망	A mess, in bad shape
여관	A hotel, an inn
여쭈다	Tell a superior, inform
연습하다	To practice, exercise
연출하다	Produce, present (a play)
열중하다	Enthusiasm, zeal
영웅	A hero, a great man
오	Oh, ah!
유산	An inheritence, property left behind
의도적	Purposefully
이따금	From time to time
임신부	An expectant mother
장기적	Long-term
재주	ability, talent
전설	A tradition, a legend
절	paragraph, passage; clause; verse
젖	The breasts
조르다	To tease, urge sb
주문하다	To order, to request
주사	A shot, an injection
지겹다	To be tedious, tiring
짐작	guess, conjecture
쫓겨나다	Chase away; to fire from your job
찢다	Tear, rend, split
채널	Channel
출근하다	To go to work
취소하다	To cancel, calloff
취업	Employment, finding a job
칠하다	Paint, coat
타오르다	Blaze, light up
탁	1. With a bang, with a snap 2. widely
판	edition, printing
평화롭다	To be peaceful
표시	A sign, signal
표시	indication, marking
하반기	The second half of the year
한구석	A corner, a nook
한하다	Limit, restrict
해답	A solution to a problem, an answer to a question
해소하다	To be dissolved, disorganized
허락하다	Consent, agree to
확립하다	establish, settle, fix
확신하다	To be confident of
흥분	excitement, excitation
흥분하다	be/grow excited
힘겹다	To be not strong enough to do
감수성	Receptivity / susceptibility
거들다	Help / assist / lend
건너편	The opposite side
경치	A scene / scenery
급속히	Rapidly / swiftly
급증하다	Surge / sudden rapid increase
깔끔하다	Be sleek and smart
꼼꼼하다	very careful / meticulous, doing it in a very detailed manner
낮아지다	Become lower
단순	Simplicity
대사	ambassador
두세	Two / three (months)
때	dirt, especially dead skin produced by exfoliation
매	whip, rod, cane
먹고살다	Make one's living
멎다	Stop
면담	An interview
모집	recruitment, collection
모퉁이	Corner
바구니	Basket
바싹	Completely
발달되다	Be developed
발음	Pronunciation
방울	(small) bell
보름	15 days, the 15th day
봉지	Bag, sack
부딪히다	Be bumped into
비상	Emergency
비서	Secretary
뿌리치다	Shake off, refuse
사업자	Businessman
상대편	The other party
세트	Set
소망	desire, wish, hope
수동적	Passively
술잔	A glass for alcohol
슬그머니	Furtively
시장	mayor
시청률	Popularity rating
신문사	Newspaper company
여군	A woman soldier
연인	A sweetheart
연장	Extension, prolongation
열흘	Ten days
예선	A preliminary match/election
옥수수	Corn
원	circle
은행나무	A ginko tree
이웃집	The neighbor's house
자부심	Pride
장차	In the future, someday
재미없다	Boring
저편	That side, direction
정신과	Psychiatry
제도적	Systematic
조절	regulation, adjustment
주거	residing, dwelling
주스	Juice
준비되다	To be ready
중단되다	To be suspended, stopped
중요시하다	Attach great importance to
지점	branch (of a store / chain)
진단하다	To diagnose
콜라	Cola
타다	to receive
편견	A prejudice, a bias
플라스틱	Plastic
환율	The exchange rate (money)
활기	Vigor, life, vitality
강사	Instructor / teacher
강수량	How much rainfall
교대	Alternation / change
구청	A ward / district office
국내외	The inside and outside of a country / home and abroad
금지되다	To be forbidden / prohibited
기도하다	To pray
기성	introspection
깨뜨리다	To break / crush
꼼짝	Cannot move
남학생	Male student
농사일	Farming
농장	A farm, plantation
데이트	Date
되돌아가다	go back, return
두부	tofu
들이켜다	drink, gulp, guzzle
따라다니다	follow, chase, go after
라운드	round
마음가짐	Mental attitude
머리칼	Hair
번개	Lightning
변화되다	To be changed
부러워하다	envy, be envious of
부재	Absence
사망	Death
생	1. raw, uncooked 2.living
서늘하다	Be cool, refreshing
성경	The Bible
소요되다	Be needed
소화하다	To digest
순간적	instanteous, momentary
시집가다	To take a husband
시청	City hall
싶어지다	To come to want
씌우다	Put a hat on somebody
야간	The night time
엇갈리다	Cross, miss eachother
엷다	Be thin, light
오락	Entertainment
오른손	The right hand
우아하다	To be elegant, refined
이것저것	This and that, one thing and another
이슬	Dew, dewdrops
인간관계	Human relations
장기간	For a long period
저자	A writer, author
전선	The battle line
정지	stop, an interruption
제의하다	Make a suggestion
조명	lighting, illumination
조화되다	harmony, agreement
줄거리	A stalk, a stem
중단	interruption, suspension
차선	A traffic lane
착각하다	To misunderstand, to deceive oneself, to be having illucinations
초상화	A portrait, a picture
출장	A business trip
쿠데타	Coup d'etat (overthrow of the government)
퇴근	Leaving one's office, coming home from work
특수성	Particularity, distinctiveness
항공기	An aircraft
활발히	briskly, actively
회화	Conversations, talk
흥미롭다	To be interesting
가져다주다	Take something to someone
각오	Readiness / preparation
개방되다	To be opened
겨자	Mustard
경고하다	To warn
경제학	Economics
골프	Golf
관심사	A matter of concern and interest
구별되다	To be separated andistinguished
국사	The history of a country
굳히다	Harden / make hard
귀국	Returning to one's home country
그간	The while / during tha time
그럴듯하다	Be plausible / specious / likely
극작가	A dramatist
기23	A flag / a banner
기울다	To tilt / lean
기적	A miracle
끌리다	To be drawn / pulled / dragged
내보내다	Let out, let go out
담	A wall, fence
동서	east and west
들여놓다	bring in, invite someone in
따스하다	Feel warm
말투	One's way of talking
명령어	Directive
목욕탕	A bathhouse
미끄러지다	Slippery
바닷물	Sea water
변신	Disguise, transformation
부친	A father
붙잡히다	Be caught
브랜드	Brand
빨다	to wash (clothes), to launder
사무	Office work
사소하다	Be trifling, insignificant
상	table
상쾌하다	Be refreshing, exhilirating
성	surname; last name
손길	An outstretched hand
순위	order, ranking
식사하다	To eat a meal
쌍	A pair, couple
썰렁하다	chilly, feel cold
암시	A hint, suggestion
앞날	The futre, the days ahead
역사상	being in history, existing historically
연주	A musical performance
우울하다	To be melancholy, gloomy
우체국	A post office
울리다	to cause to weep
육상	On land, on the ground
음주	Drinking (alcohol)
이별	Parting, separation; divorce
인재	A man of ability
인종	A human race
일시적	Of a day
재밌다	interesting, fun
전문적	Of a specialist nature
젊음	Youth
점잖다	To be dignified, well-bred
조개	shellfish, clam
주무시다	To sleep (respectful word)
중계방송	A relay, a hookup
중독	Poison
지급	supply, pay
진실하다	Be true, truthful
차창	car/train window
초청하다	To invite
출발점	The starting point of a trip
출판	Publication, publishing
출현하다	Appearance, turning out
클럽	Club
키스	Kiss
탈출하다	To escape, get away from
판사	A judge
허락	Consent, assent, approval
확신	Conviction, firm belief
흐리다	Cloudy (weather)
걱정스럽다	Anxious / uneasy
건설되다	To become constructed
고개	The nape of the neck
고프다	Hungry / famished
그제야	For the first time / not … until
금연	Prohibition of smoking
기성세대	Old people
기술하다	To describe / give an account of
까치	Magpie
꿈속	In a dream
나비	Butterfly
남북	North and south
납득하다	To convince, persuade oneself
단	end
대사관	Embassy
독창적	Original
되풀이되다	be reiterated, be done over again
떠나가다	to go away; to leave; to depart
떠들썩하다	noisy, boisterous troubled, disturbed sensational, much discussed
뜻대로	just as wished, at one's pleasure, as desired
레스토랑	restaurant
로봇	robot
만점	Perfect score
매달	Every month
모여들다	gather, flock
묵다	to become old, to become antiquated
바깥쪽	The outside
배고프다	To be hungry
버섯	Mushroom
보수	Conservation
보안	Preservation of the public peace
뵈다	look, appear
비웃다	Laugh at, ridicule
비키다	Move aside
사나이	A man, a male
사모님	Older more respected ajuma
삼	Three
상징적	symbolic, emblematic
색다르다	Be different, novel
세미나	Seminar
세제	detergent, cleaning material
속삭이다	Whisper
시일	time, days
시합	A contest, match
신속하다	Be quick, rapid, speedy
신제품	A new product
신중하다	To be prudent, cautious
썩	Very much, greatly
암컷	A female, a she (opp. 수컷)
여행하다	To travel
예고하다	Warn, give advance notice
위반하다	To violate (the law)
윗몸	The upper body
은은하다	To be distant, faint, indistinct
이해관계	Mutual understanding
익히다	to cook something through
일대	One great/large
입력	Power input
자연현상	Natural phenomena
정류장	stop, a station, bus-stop
정신없이	Feel distracted and scatter-brained
정직하다	honesty, uprightness
조정하다	To regulate, adjust, coordinate
주름	Wrinkles
중요	importance, consequence
챔피언	Champion
최신	Newest, the latest
축하	Congratulation, celebration
취소	Cancellation, anulment
캐릭터	Character
커튼	Curtain
팬	Fan, enthusiast
해롭다	To be harmful, injurious
현관문	The front door
활발해지다	To become lively
회복되다	To be recovered
희생하다	To sacrifice
가능해지다	To become possible
겨울철	The winter season
고추장	Red pepper paste
골프장	Golf course
공연히	Futile / vain / useless
과정	Process / course
국수	Noodles
국제적	International
그루	1. a root 2. stubble
그전	Former days / the past
금고	A safe / strongbox
꾸중	Scolding, a rebuke
끌어당기다	To draw near
끼	A meal / a repast
능동적	Activity; voluntary, of its own nature (opp. 수동적)
달빛	Moonlight
당분간	For the present
도움말	Helping words
되살리다	revive, recreate
뒷산	The back side of a mountain
땜	because, because of
맵다	Spicy
메다	Put on one's shoulder
몰려오다	Come in crowds
물질적	Material
미인	A beautiful girl
믿어지다	Become believable
반죽	Kneading; dough
반지	Ring
밤	chestnut
배치	Arrangement
백인	Caucasian
본	An example
본사	Main office
부르다	to be full (from eating)
불평등하다	Inequality
비타민	Vitamin
빌딩	Building
빠뜨리다	Throw into (a river); entice, entrap
산속	The heart of a mountain
새로이	newly, afresh
서양인	A Westerner
소지품	one's things
송이	A bunch, cluster
쇠	Iron
수컷	A male of the species
승리하다	To win
식초	Vinegar
심부름	Errand
씨앗	Seeds
야외	The fields, the outskirts
얻어먹다	Go about begging
엄숙하다	Seriousness, solemnity; being grave, serious
여가	leisure, spare time
여동생	Younger sister
연상하다	Association of ideas
옆집	The house next door
오래간만	After a long time
오래도록	For long, a long while
올려다보다	Look up
외다	To repeat back (an order)
외침	A shout, a cry
이빨	A tooth
이해	profits and losses
일손	Work in hand
잠바	Jumper
잠수함	Submarine
장수	A tradesman, merchant
장학금	Scholarship
재다	measure, guage
쟤	That kid
점심시간	Lunchtime
지도하다	To lead, instruct
지적	something which is intellectual.
진로	A course, direction, path
진행자	Leader of the performance
쪽	side, Way, direction
찾아다니다	To go around to meet somebody / see places
책임감	Feeling of responsibility
체온	Body temperature
초밥	Japanese vinegared rice vegetables
출구	An exit
출입문	Door for exiting and entering
통과	Passage
포장마차	A wheeled snack bar on the street
푸다	Dip out, bail out
피망	A pimento
필름	Film
한결	Stands out conspicuously, especially
한여름	Midsummer, the middle of summer
항공	An airport
호선	The track number for a train
회전	Revolution, rotation
휴지	Toilet paper
가려지다	be blocked from view
가위	Scissors
고속	High speed
곧다	Be straight / upright / erect
골치	Worry / anxiety
구하다	1. To buy / purchase / 2. look for / seek / want
그때그때	whenever, according to circumstances
내달	Next month
넷째	Fourth
놔두다	Leave as it is, let it be
늦어지다	To become late
도망가다	Make a go for it, escape
독하다	Be poison
땅콩	peanut
뜰	yard (i.e front / back yard
뜻밖에	unexpectedly, surprisingly
만	full, whole
명단	List of names
무의미하다	Be nonsense
문구	passage, paragraph
뭣	What (thing)?
미만	under, below; less than
백색	White
비바람	Rain and wind
사기	morale, fighting spirit
사망하다	To decease, pass away
사무직	Working in the office not in the factory
소질	temperament, character
솜	Cotton
시디롬	Cd-rom
식생활	Dietary life
신호등	Signal light, blinker
신혼여행	the honeymoon (the trip after the wedding)
실	Thread (to wind thread)
씩씩하다	Be brave, valiant
연구실	A laboratory
월드컵	World cup
유머	Humor
의류	Clothes, dresses; clothing
입원	Hospitalization
잊혀지다	To become forgotten
잘살다	To be affluent, well-off
장가	To get married
적응	Adaptation
정리되다	To be adjusted
조	group
졸업생	A graduate
죽다	(hyperbolic) to be unbearable, to be irresistible, to die of x
창피하다	To be ashamed
친절	Kindness, goodness
침실	Bedroom
태권도	Tae kwon do
토론하다	To debate, discuss
합하다	Harmonize with, be in accord with
핸드백	Handbag
고기겹빵	Hamburger
가정교사	Private tutor
감사	Thanks
공통적	Commonly
교육자	An educator
교재	Teaching material / insruction materials
기타	guitar
길어지다	To become long
깨소금	Powdered sesame mixed with salt
나빠지다	To become worse
남	male
놓아두다	Leave as it is, let it be
대접하다	to treat, to serve (somebody)
두통	headache
뛰어내리다	jump down, leap down
무궁화	The rose of Sharon
바이러스	Virus
방바닥	room's floor
번거롭다	Be troublesome. 할 일이 많아서 아주 바쁘다
사냥	Hunting, a hunt
사회생활	Social life
설거지	Dishwashing
수년	Several years
수출하다	To export
숙소	one's address
슈퍼마켓	Supermarket
심리적	Psychological
연기	postponement
위로	consolation, solace
이용자	A user; visitor
입력하다	To input (data into the computer)
자격증	A qualification certificate
진료	Medical examination and treatment
창가	Next to a window, or, the window's edge
초조하다	Be impatient, irritated
타다	to mix; to dilute; to water down
한잔하다	To drink a glass of liquor
함께하다	To do it together, with somebody
합격하다	To pass an exam
화장지	Soft paper used when applying makeup
힘껏	With all one's might
가요	A song
감상	Appreciation
공짜	something gained free of charge, freebies
공통되다	To be common
그만하다	Be about the same / be neither better nor worse
나들이	Going out, an outing; making a short visit to sb / somewhere
녹이다	Melt, dissolve
눈가	The eye rims
도망	Escape
동기	same period, same time
모기	A mosquito
미니	Mini
방면	Direction
법적	Legal
벤치	Bench
보수	restoration, maintenance, repair
볼일	business, errand, engagement
부끄러움	shame, disgrace
비누	Soap
비행	misconduct; delinquency
빗줄기	Great streaks of rain
사회학	Social science
성적	sexual
세수	Hand-washing
순진하다	To be naive, pure
스웨터	Sweater
심심하다	to be bored
어려워지다	To become difficult
여행사	Travel agency
올라서다	Stand up
왼손	The right hand
유학생	A foreign student
은	Silver
잘생기다	To be handsome
장애인	A handicapped person
재활용품	A recycled product
저러다	Like that
저리	That place
절약하다	To economize
정반대	Direct opposition, the exact reverse
조	group, unit
진동	vibration, shake
찌개	A pot stew
추천	A recommendation
학점	A unit, a point, a credit
한가하다	To be free, not busy
합격	Success in an examination
환영하다	To welcome
간접적	Indirect / mediate
갈다	to change, to replace, to switch (in general)
경영하다	To manage / adminster
그리움	Yearning / affection
그사이	The while / the meantime
기념하다	Commemorate
기도	A prayer
길거리	A street
꽃잎	A petal
넥타이	Necktie
대강	General principles
독립하다	To become independent
돌려주다	return, repay
들이마시다	breathe in, inhale
뛰어오르다	jump up, bounce, skyrocket, soar
라이터	lighter
문밖	Outside the door
방송하다	Broadcast
보충하다	replenish, replace, fillup
불완전하다	To be imerfect
불평	Dissatisfaction
붐비다	Be congested, crowded; to be full of
생활환경	Life environment
서명	signing, autographing
손등	The back of the hand
역사학	The study of history
영	Really, totally
오리	Duck
요리사	A chef, a cook
원서	An application, a written request
월	A month
이론적	Theoretical
이제야	These days
임신하다	To be pregnant
입원하다	To enter a hospital
자취	A trace, vestige
잠그다	To lock
잡수시다	eat, drink
장난감	A toy
장례	A funeral
전기밥솥	Electric rice cooker
지금껏	So far, till now
지름길	A shortcut
지진	Earthquake
참석자	Persons present
창구	A window
최저	The lowest, the minimum/lowest price
코미디	Comedy
튀기다	To fry; splash, splatter
필수	necessary, indispensable
하품	Yawning
횟수	The number of times, the frequency
흐리다	(air, water, material) to be unclear, impure, turbid, muddy
가능	Possibility
값싸다	Cheap / low-priced
계란	A chicken egg
교문	A school gate
권투	Boxing / K1
긴장감	Feeling of tension
김	steam; vapor
넷	4
뒤편	behind, back side, back of something
매달다	Bind up, hang: 묶어서 드리우거나 걸다.
매주	Every week
문제되다	Become a problem
받침	Support, prop
북	North
불이익	disadvantage, drawback
불필요하다	To be unnecessary
산부인과	Obstetrics and gynecology
새우다	Sit up all night
서명하다	To sign
수	way, method, Number
수고하다	To work hard
수학	study / learn (a discipline)
신부	(religion) father, priest
쓸데없다	To be useless
아뇨	No, nay
아래쪽	The lower part, the bottom
아스팔트	Asphalt
아하	Dear me! Goodness!
알코올	Alcohol
액세서리	Accessory
에어컨	Air conditioner
염려하다	To worry, be anxious about
오이	Cucumber
외삼촌	An uncle on one's mother's side
요	Right near at hand
웃음소리	The sound of laughing
위쪽	The upper direction
음료수	Drinking water
인쇄	printing, typography
잔디	Lawn
전세	renting with a big downpayment and not paying month to month
조깅	Jogging
초대	An invitation
치다	rain, snow, blow, pour
캠퍼스	Campus
터널	Tunnel
통	flow, pass, circulate
퇴직금	Retirement grants
환갑	one's 60th anniversary
가만있다	Remain still / motionless
간편하다	Simplicity / convenience
감동적	Sensational
건너오다	To come across to this side of something
관광지	Tourist area
교복	School uniform
교포	A Korean living abroad
귀가하다	To return home
날아다니다	Fly about
더더욱	even more, much more
등록금	tuition, registration fee
뛰어다니다	run around
마음씨	Disposition, nature
만	only; As many as, full, complete
메모	Memo
몇십	In the tens
몸매	one's figure
몸무게	Body weight
무관심	Indifference, unconcern
반짝이다	Shine, glitter
배달	delivery; distribution
번역	Translation
부인	A woman, a lady
분주하다	Be busy, crowded
비닐봉지	Plastic bag
비판적	Critical
뺏다	Straight
사전	dictionary
서랍	A drawer
소나기	A sudden rain shower
소중히	seriously, with care
손잡이	A handle, knob
수도꼭지	A faucet, tap
실례	rudeness, impolite
싸구려	cheap, inferior (a bargain)
안녕	hello/goodbye
안되다	(to be) sorry, to feel regretful (about something negative)
약국	Pharmacy
어찌나	extremely, quite, awfully
엉터리	Fake, sham
연하다	Tender, soft, mild
원숭이	A monkey
위법	illegality, a breach of the law
육체적	Corporeal, of the flesh
음력	The lunar calendar
이혼	Divorce
일회용	For one time use
잔디밭	lawn, grass
전문직	Specialty job
전화기	Telephone receiver
제출	presentation, submission
지난주	Last week
진달래	Azalea
쪽	a part, piece
찌다	(transitive) to steam (food), to cook with steam
차남	one's second eldest son
채점	marking, grading, scoring
침착하다	Self-possession, composure
캄캄하다	To be pitch-black
타자기	A typewriter
팬티	Panties (male and female underwear)
편히	Easily, comfortably
포인트	Point
포크	Fork
한밤중	Midnight, middle of the night
효도	Filial piety
가구	furniture
간호사	Nurse
개나리	A forsythia / a golden-bell tree
고등학생	High school student
골목길	An alley
관람객	spectator, visitor, audience
귀가	Returning home
그리워하다	Yearn / be attached to
기억나다	To memorize
기침	Coughing
노랫소리	A singing voice
다섯	5
닭고기	Chicken meat for eating
대학교수	University professor
뒷문	back door
딸아이	Daughter
레몬	lemon
만족스럽다	Satisfied
미움	Hatred
바가지	A gourd dipper
발끝	On tiptoes
배꼽	The navel
병실	An infirmary
봉사하다	serve, render service
비행장	An airfield
사랑스럽다	Lovely
숟가락	A spoon
술병	A bottle of alcohol
습기	moisture, humidity
쓰이다	To be written
엽서	A postcard
예보	forecast, predict
요일	A day of the week not the weekend
욕실	A bathroom, a bath
용감하다	To be brave, courageous
운전기사	The driver
위험성	riskiness, jeapordy
익다	to be skilled, to be experienced, to be familiar
일	one
장마	The rainy spell in the summer
재학	To be in school, be attending school
전기	biography
전시하다	To display
정기적	fixed, regular (time sth)
종교적	Of religions
주관적	Subjective
직장인	A worker
진심	The whole heart, sincerity
질문하다	Ask a person a question
짧아지다	To become short
찌다	(intransitive) to get fat, to gain weight
책가방	Bookbag
천국	Heaven
치약	Toothpaste
큰절	A deep bow
학과	A department in a college
후회	repentance, regret
강조	Emphasis / stress
게시판	A notice board / a bulletin board
공통점	A common point / a common feature
과외	Extracurricular work
교내	Inside the school
구15	Ward / district
금요일	Friday
김밥	Roll of rice and vegetables
내적	Internal
놀이터	Playground
다녀가다	Drop in for a short visit
답장	answer; written reply
때때로	sometimes
뜨다	(transitive / intransitive) to leave, to depart
마라톤	Marathon
매스컴	Mass communication
무	non-, un-, a-; a prefix marking an absence of something
묵다	to stay (at a place), to lodge
바나나	Banana
발등	The instep of the foot
밤새	All night
별일	A particular thing
보내오다	받다 receive
부채	A debt, liabilities
불법	Buddhism
블라우스	Blouse
사업가	businessman, entrepreneur
사이좋다	Be on good terms with
세상에	In the world
수고	toil, labor, pains
수요일	Wednesday
슬퍼하다	sorrow, feel sad
시금치	Spinach
신청서	Application, application form
쓰레기통	Garbage can
아랫사람	Subordinate
앞쪽	The front, the fore part
앨범	Album
양	sheep
여전하다	Be unchanged, the same as before
영남	The southeastern part of Korea
옥상	On the roof
왼발	The right foot
운전하다	To drive
위	stomach
일기	weather
일자리	A job, position
자매	Sisters
저번	Last time, the other day
전시장	An exhibition hall
절약	thrift, savings, economy
정답	The right answer
정오	Noon
제대하다	Be discharged from the military
졸다	doze, take a nap
즉석	instantly, impromptu
지방	fat, grease
차차	Gradually
추측	Guess, conjecture
충고	Advice, counsel, suggestion
코피	A nose bleed
턱	a cause; a reason; a possibility (used only to emphasize that no such thing exists) as in "to have no idea/ to have no clue"
팩시밀리	Facximile, fax
한낮	Noon
할인	A discount
가득히	Full
간호	Nursing / care
갑	1. The first 2. the former
건너	The other / opposite side
걷다	(of sheets) to fold up
겁나다	Be frightened / scared
고구마	Sweet potato
국기	The national flag
금메달	Gold medal
노트	A note
눈감다	Close the eyes
눈뜨다	Open one's eyes
대입	abbreviated word for "college entrance"
대화하다	To converse
도마	A chopping board
동화책	A fairy tale
딸기	strawberry
땅바닥	bare ground
모집하다	Call/appeal for
미워하다	Dislike
밤색	Chestnut color, maroon
밥맛	Appetite
배우자	A mate, life partner
복사	Reproduction
볶음밥	Frizzled rice
성별	Sex distinction
세탁	Laundry
소문나다	A rumor starts
소용없다	To be useless
속상하다	Be distressing
손수건	A handkerchief
송아지	A calf, baby cow
수돗물	Tap water
수만	Tens of thousands
수입되다	To be imported
수입품	An imported product
술자리	A banquet
식기	An eating vessel
싼값	A low price
안	idea, suggestion, opinion, thought
안부	safety, welfare
양주	Foreign wine/liquors
어린이날	Children's Day (may 5th)
영화배우	Movie actor
오른발	The right foot
용서	pardon, forgiveness
우편	post, mail
이사하다	To move house
일등	First class, first class/grade
작아지다	Become smaller
정장	Full dress, uniform
좁히다	Make narrow, restrict
좋아	“That's good”
죽	in a manner arranged in a row; while arranging in a row
줄무늬	A stripe
지워지다	To be erased
지저분하다	Be messy, soiled, dirty
진통	Labor pains, travail
찬성하다	To approve, support (a plan)
참석	Attendance, participation
초콜릿	Chocolate
최고급	The highest grade/class
최상	The best, the finest
최악	The worst
출국	Leaving a country
친해지다	To get close, to get friendly
코끝	The tip of one's nose
터미널	Terminal
피자	Pizza
조선적	Korean (adjective)
햄	Ham
환영	Welcome
가로수	A roadside tree
간식	Snack
감	persimmon
개다	To clear up / become clear (weather)
고급스럽다	To be high-class
고소하다	Taste of sesame oil / taste of a nut
공주	A royal princess
깨어지다	To waken
남	south
네거리	Crossroads
노란색	Yellow
녹음하다	To record
대여섯	About five / six
되돌아보다	To look back on
등산로	hiking trail
마사지	Massage
만	10,000, ten thousand, myriad
먹히다	to be eaten, swallowed
몸살	Flu aches and pains
무더위	High humidity
무용가	Dancer
박스	Box
반기다	Rejoice, be glad of
밥솥	Pressure cooker for rice
베개	A pillow
벨트	Belt
복사하다	reproduce, copy
붓다	(intransitive) to swell up
비	gravestone; tombstone
사계절	The four seasons
사과하다	To apologize
사투리	A dialect
상금	Prize money
수저	A spoon
식욕	appetite, desire
앞바다	The offing sea
얄밉다	Be offensive, mean
양상추	Lettuce
여대생	Female college student
연기하다	To defer, postpone
온라인	Online
외갓집	one's mother's maiden home
외할머니	A maternal grandmother
유능하다	To be competent, talented
유적지	Place where remains/cultural-historical remnants are
음악가	A musician
응답하다	An answer, a reply
이롭다	Be good for
이분	Divide into two
인삼	Ginseng
인상	physiognomy
입사	enter/join a company
자	ruler (measuring instrument), straightedge
재활용	Recycling
점원	A shop-assistant
제삿날	Day of the ceremony
주름살	Wrinkles
참고하다	To refer, consult
찻잔	A teacup
철학적	Philosophical
초대	first of a family line; first age
추천하다	To recommend, say a good word for
칫솔	A toothbrush
큰길	main/principal road
판매되다	To be sold
편	rail, train service
포근하다	To be soft and comfortable, downy
포도	grape(s)
하나님	God
학력	Academic background, formal schooling
한정하다	To limit, restrict
향상되다	To be impoved, advanced
홈페이지	Homepage
횡단보도	Crossing
가톨릭	Catholic
강당	A lecture hall
건조하다	Ry / arid / become dry
걷기	Walking
고모부	The husband of one's paternal aunt
공중전화	A public payphone
공통	Commonness
과거	classical examination system for the government service in old Korea
국가적	National / state
귓속	The inner ear
그래픽	Graphic
근교	Suberbs
기초적	Fundamental / basic
녹음	Recording
다양성	Variety
대상자	subject, recipient, candidate,
동그라미	circle
떠나오다	미국으로부터 to come back from the US
레이저	laser
마중	Meeting, reception
밤중	Midnight
배드민턴	Badminton
배부르다	To be full
버튼	Button
보수적	Conservative
불확실하다	Be uncertain
비만	Fatness, corpulence
빗방울	Raindrops
사회자	President
샤워	Shower
서투르다	unskilled, clumsy
세탁기	Washing machine
손뼉	The flat of one's hand
손수	With one's own hands, personally
송편	Rice cake steemed over pine needles
시들다	To wither, die, fade
시디	C.D.
신사	A gentleman
신혼부부	Newlyweds
싱겁다	Taste flat, have no flavor
쓸데없이	To have no use
야하다	To be gaudy, garish
어쩌다가	By chance, accident; sometimes
옛날이야기	An old story
오븐	Oven
온종일	All day long, the whole day
와인	Wine
왕비	Queen
우승하다	To take first place
운반	conveyance, transport
웃어른	one's elders
인사말	Words of greeting
자판기	Vending machine
장모님	A man's mother in law
저녁때	Evening time
저울	A balance
적어지다	To become smaller
지폐	Paper money
진실로	Truly, honestly
촛불	Candle-light
출퇴근	Go to and come from the office
치과	A dentist
테스트	Test
통역	Interpreting
퇴근하다	To go home from work
표시하다	to express, state
피로하다	To be fatigued, weary
하	Below, underneath
한데	The open air, outside, the exterior
혼잣말	Talking to oneself
화나다	Get angry
효도하다	To be a good son/daughter to one's parents
힘없이	feebly, weekly
가로	Width / breadth
갈아타다	Transfer (bus / subway)
건넌방	The room opposite the main living room
곧이어	Soon hereafter
공기	bowl
굉장하다	Be grand / magnificent / splendor
기업인	Businessman
긴장되다	Be under tension
깨끗해지다	Become clean
낚싯대	A fishing rod
남동생	Younger brother
냇물	A stream, brook
단골	Custom, connection
단맛	A sweet taste
담요	A blanket
대	stalk
더러워지다	Get dirty
데우다	to warm, to heat up
도착	Arrival
동그랗다	To be circular
뛰어나오다	bolt out of. run out of, burst out of
레저	leisure
로터리	rotary
무덥다	sultry, sweltering
뭘	What (implicit directobject)?
반대편	The opposite side
발바닥	The sole of the foot
발톱	A toenail
밝아지다	Become bright
밤새다	To stay up all night
부잣집	Rich man's house
분명해지다	To become clear
사진기	Camera
산길	A mountain path, road
상추	Lettuce
섭씨	Celsius
소시지	Sausage
쇼핑	Shopping
수업	practice, training
스케줄	Schedule
스키	Ski
시외	Outside the city, suberbs
심각해지다	To become serious
싹	A bud, sprout
씻기다	To be washed, be cleaned
안심하다	security, assuredness, relief
약	anger, fury
약수	Medicinal water, mineral water
약품	Medicines, medical supplies
양배추	Cabbage
양보	concession, compromise
양옆	On both sides
얕다	To be shallow, superficial
어두워지다	become/get dark
어쩜	Well, I guess that, is extremely…..
엊그제	The day before yesterday, a few days ago
여고생	Female high school student
여왕	Queen, empress
연기되다	To be put off, postponed
예약	Pre-engagement, reservation
올라타다	Board (a plane), get into
운동화	Sports shoes
이곳저곳	Everywhere
이다음	Next
일회용품	A product to be used only once
읽히다	To get a person to read, to get a person to learn
잡수다	eat, drink
장사꾼	A trader, merchant, dealer
점심때	afternoon
주일	A week
즐거워하다	To enjoy it
집중하다	To concentrate
짜다	salty
짜증스럽다	To be annoying
천재	genius, talent
초등학교	Elementary school
초보	Initial, first steps
초여름	Early summer
초저녁	Early in the evening
충돌하다	Collide, clash with
코트	Court
피곤	fatigue, exhaustion
학비	Tuition
해	harm; damage; evil; injury
해외여행	Foreign travel
효자	A dutiful son
감소되다	To be reduced / diminished
강변	A riverside
공연되다	To give a public performance
공휴일	A legal holiday
괴로워하다	To distress / trouble
교시	Teach / instruct / enlighten
그리로	Over there
까먹다	Crack / peel and eat
깜빡	With a flash / twinkle
깡패	Gangster
꾸다	Borrow / loan
낚시꾼	An angler
다양해지다	To be various
대중교통	Mass transportation
데려오다	Go with
등록하다	register, enroll
뛰놀다	to frolic, romp, frisk (excitement, joy)
뛰어오다	come running
라켓	racket
리터	liter
마요네즈	Mayonnaise
마흔	Forty
만세	10, 000 years
만화가	Cartoon artist
맘대로	As you want
머리말	A preface
면접	face-to-face meeting; meeting in person; personal interview
명함	Name card
몸속	In one's body
무책임하다	Not responsible
반짝거리다	Twinkle-twinkle (stars)
밤새우다	Sit up all night
번지	Area of land
볼펜	A ballpen
빨간색	deep-red, crimson
사립	Private
사생활	Private life
사이사이	Every now and then
사자	A lion
새소리	Bird voice, ”chirp”
생활수준	The standard of living
서툴다	poor, awkward
석사	Master
성당	A church
속마음	Inner heart, feeling
손잡다	Take a person by the hand
숙녀	A lady
순하다	Be gentle, docile
시댁	one's husband's family/house
시부모	one's husband's parents
신체적	Physical
실수하다	To make a mistake
쓴맛	A bitter flavor
야옹	Mewing, meowing
얼마간	Some, somewhat
올여름	This summer
외제	Of foreign manufacture
외출하다	To go out (of doors)
욕하다	To insult, to say bad words
위아래	Up and down
음반	A phonograph record
의논	consultation, conference
이	two
이래서	This way, this direction, here
이발소	barber's shop
자살하다	Commit suicide
자연적	Natural
장례식	A funeral
재수	luck, fortune
재작년	The year before last
재채기	sneeze, sneezing
전구	An electric bulb
전문점	Exclusive store
전통문화	Traditional culture
정거장	A railroad station
존댓말	Respectful speech
주전자	A kettle, teakettle
지우다	to make someone carry, to load something up; to charge person with a duty
찬성	approval, assent
초보자	A beginner, neophyte
초청장	An invitation (card)
촌스럽다	Unfashionable
카레	Curry
컨디션	Condition
코스모스	Cosmos
킬로	Kilo
토론자	A debator, a disputant
튼튼히	Strongly, firmly
티셔츠	T-shirts
페인트	Paint
평상시	Normally
학교생활	school life, student life
한둘	One / two
해물	Marine products
형	type, model
혼나다	Get frightened, scared
가만	Quietly / softly
감정적	Emotional
강북	North of the river
거리	side (as in a side dish); road, street
고무신	Rubber shoes
고춧가루	Red pepper powder
관람	Inspection / viewing
교외	Outside the school / extramural
교육비	Tuition / the cost of a school education
국립	Government established
금	line, crack
기억되다	To be remembered
까다	Peel / husk
꽃씨	Flower seed
꾸준하다	Be steady / unflagging
난방	A heated room
내용물	Contents
녹화	Tree-planting
농구	Basketball
달다	to weigh
뒷골목	back street; back alley
들어주다	grant, comply with
디자이너	designer
따로따로	separately, individually
뛰어나가다	fly out, run out
뛰어놀다	play around, round around, frisk
라이벌	rival, rivalry
매번	Every time
먹다	be deaf, to lose one's hearing
무관심하다	Be indifferent to
무사하다	Be safe, peaceful
밤낮	Night and day, always
배구	Volleyball
번역하다	To translate
병아리	Chick, baby chicken
부지런하다	Be diligent
부피	bulk, size
비기다	End in a tie, to be even-even. Same as 무승부를 기록하다
생활용품	Necessities for daily life
선풍기	A fan
세로	Length
섹시하다	To be sexy
소비하다	to consume, spend (time / money)
수리하다	repair, mending
스물	Twenty
식료품	Articles for food
식히다	To cool, let cool. 차게 하다
싫어지다	To become distasteful
씻기다	to wash
얼리다	Freeze, make ice
여직원	Female employee
열리다	to bear fruit
옆방	The room next door
오피스텔	Office hotel (studio apt)
올가을	This fall
와이셔츠	A white dress shirt
원피스	(one-piece) a dress
윗사람	A superior, one's older somebody
이민	Emigration
이성	opposite sex
이혼하다	To get divorced
입사하다	To join/enter a company
재우다	Put to sleep
전시되다	To be exhibited, ddisplayed
졸리다	Feel sleepy, drowsy
졸음	sleepiness, drowsiness
종이컵	A paper cup
주문	spells
지능	intelligence, intellect, raw intelligence
쩔쩔매다	To be at a loss, be confused
철	maturity; good sense
청바지	Blue jeans
추가되다	To be added
치료법	A curative means
코끼리	An elephant
콘서트	Concert
큰소리	A loud voice, loudly
큰아들	Oldest son
특급	In a special class
평일	A weekday
풀어지다	To get loose; to turn soft (noodles)
한겨울	Midwinter, the dead of winter
한평생	A lifetime
해수욕장	A swimming beach
핸드폰	Cell phone
허허	Ha-ha, with a laugh
호실	Tells you the room number
휴지통	Waste paper basket
흐려지다	Get cloudy, overcast
희망하다	Hope
힘들어하다	To be exacting, tolling
강의하다	To give a lecture
걱정되다	To become worried
공연하다	Offer a performance
귤	A Jeju orange
내과	Internal medicine
된장찌개	doenjang jjigae, a sort of stew made of 된장 and beef (sometimes seafood)
목걸이	Necklace
무지개	A rainbow
문법	Grammar
볶음	Roasted sth
볼링	Bowling
비둘기	Pigeon
생활비	Cost of living
스키장	Place to ski
시대적	Of the times
쓰다	to be bitter
앞문	The front gate
인도	pavement, sidewalk
책방	Reading room
추가하다	To add sth, to supplement
칠판	The blackboard
크리스마스	Christmas
탁구	ping-pong, table tennis
현대적	Modern (adj)
구	9
나흘	Four days
늦가을	Late autumn
다이어트	Diet
목요일	Thursday
못생기다	Ugly
영화관	Movie theater
예술적	Artistic
장모	A man's mother in law
중국집	Chinese restaurant
지우개	An eraser
지하도	Underground road
튀김	Batter-fried food
고궁	An ancient palace
고속버스	Bus for the freeway
단추	A button
대중적	Of the masses
뚱뚱하다	to be fat
미역	Brown seaweed
반말	Crude language
분홍색	Pink color
사	four, the fourth
소포	A parcel, package
손녀	Granddaughter
수영장	Swimming pool
아래층	Lower floor
일본어	Japanese
작은아버지	An uncle younger than your father
잠옷	Pajamas
장갑	A pair of gloves
초순	The first third of a month
퇴원하다	To leave the hospital
하순	The final third of the month
갈비	The ribs
기혼	Married
도장	stamp; seal
동물원	zoo
모레	The day after tomorrow
삼계탕	Chicken soup
생신	(honorific) birthday
서른	Thirty
시내버스	Inner-city bus
아홉	Nine
예약하다	To book in advance, pledge
우표	A postage stamp
장미	A rose
천둥	Thunder
퇴원	Leaving the hospital
파란색	Blue
게으르다	Lazy
기념품	A momento
냉면	Cold noodles soup
단풍	Fall foliage
독일어	German
떡볶이	tteokbokki (stir-fried tteoks seasoned with red pepper paste)
문학적	Literary
미끄럽다	To be slippery
복숭아	Peach
비빔밥	Vegetarian dish of rice and vegetables
여든	Eighty
외아들	The only son
이따가	A little later
일흔	Seventy
장인	A man's father in law, the wife's father
화요일	Tuesday
강아지	Puppy
닷새	Five days
동서남북	everywhere; all directions
선물하다	Give a gift
얼음과자	Ice cream
외할아버지	A maternal grandfather
요리하다	To cook (food)
입국	Entering a country
주차	Parking
체육관	Gymnasium
최소	At the least, the minimum
칠	Seven
칼국수	Knife-cut noodles
큰아버지	Uncle older than one's father
홍차	Tea, black tea
국민적	National / for citizens
국제선	International airline
다섯째	Fifth
동양인	Oriental person, Asian
맛없다	Bad flavor
백	Hundreds of
사십	40
안과	Ophthalmology
연락처	a way to make contact (usually means a phone number)
연세	Age, years of age
예식장	A ceremony hall
월세	Monthly rent
위층	The upper floor
인삼차	Ginseng tea
진찰	A medical diagnosis, investigation
초록색	Green
축구공	A soccer ball
큰딸	Oldest daughter
팔	eight
결석	Absent
김치찌개	Spicy cabbage soup
녹차	Green tea
독감	Influenza
만두	Chinese dumplings
발음하다	Pronounce
보라색	Purple
복습하다	To review
스케이트	Skate
실례하다	To be impolite
여섯	Six
연두색	Light green
온돌	The korean under-floor heating system
육	The number six
일곱	Seven
출입국	Entry into a country
클래식	Classic
팝송	Pop song
팩스	Fax
국내선	Domestic airline
떡국	Korean dish consisting of sliced tteok, beef, and egg, traditionally eaten during the Korean New Year
복습	Reviewing
삼십	30
성함	Your (his) esteemed name
세탁소	Laundromat
시외버스	Inter-city bus
야구장	Baseball field
오십	Fifty
운동복	Exercise clothes
작은아들	Younger son
잠자리	dragonfly
주차하다	To park
중국어	Chinese
청소기	A vacuum cleaner
칠십	Seventy
필통	Pencil case
학생증	Student identification
형수	The wife of one's older brother
공항버스	Bus to the airport
관광버스	Tourist bus
그저께	The day before yesterday
냉방	A cold / unheated room
눈병	An eye disease
배추김치	Pickled cabbage
사탕	Sugar
색연필	Colored pencil
소아과	Pediatrics
양력	The solar calendar
예순	Sixty
오	five
작은어머니	An aunt younger than your mother
축구장	Soccer field
조선글날	Korean writing system national holiday (January 15)
조선료리	Korean food
넉	The fourth
메일	Mail
복사기	Memeograph
빗	A comb
설렁탕	Beef soup with rice
십	10
아드님	Your esteemed son
결석하다	To be absent
기념일	Commemoration day
까만색	Black
내후년	The year after next year
따님	honorific of 딸 (ttal, “daughter”)
쉰	50
시아버지	one's husband's father
식품점	Grocery store
약혼녀	A girl who is engaged
어저께	Yesterday
영상	above zero
예매하다	Advance purchase
예습	Preparation of lessons
예습하다	To prepare lessons, rehearse
육십	Sixty
출석하다	attendance, presence
큰어머니	The wife of the elder brother of one's father
팔십	80
멍멍	A bruise
분필	Chalk
약혼자	A fiance, an engaged person
양식	Western food
억	One hundred million
여덟	Eight
외과	Surgery
제과점	Confectionary store
중식	Chinese food
케첩	Ketchup
편의점	Convenient store
갈비탕	Beef-rib soup
검정색	A large sum of money
미용실	Beauty salon
아흔	Ninety
이십	Twenty
일식	Japanese food
작은딸	Younger daughter
저곳	That place over there
초등학생	An elementary school student
하얀색	White
강원도	Region surrounding seoul
경기도	Region surrounding seoul
경복궁	Region surrounding seoul
경상도	Kyung-San-Do province (ulsan / kyungju)
경주	Region surrounding seoul
고구려	Region surrounding seoul
고려	Region surrounding seoul
광주	Region surrounding seoul
구십	90
그렇게	And so. like that
금강산	The Diamond Mountains
김포공항	KimPo Domestic (sometimes international) airport
깍두기	Sliced white radish kimchee
남대문	Seoul's old south gate
남대문시장	Shopping center in seoul
남미	South america
남산	Mountain in south central seoul
뉴욕	New york
대구	Daegu city
대전	Daejon city
대학로	Daehangno, neighborhood in Seoul north of the Han River
남조선	South Korea
덕수궁	Deoksugung Palace
도쿄(동경)	Tokyo
독일	Germany
동대문	Sungnyemun, one of the Eight Gates in the Fortress Wall of Seoul
동대문시장	Dongdaemun Market, large commercial district in Jongno-gu, Seoul
러시아	Russia
런던	London
미국	America
백두산	Mt. Paekdu (sacred mountain in North)
백제	Historical Korean government
베이징(북경)	Beijing
부산	Busan, city in SE Korea, with largest beach in S.Korea
조선	North Korea
서울	Seoul
서울역	Seoul train station
설악산	Famous mountain
세종대왕	King sejong, who invented Hangul
신라	One dynasty in ancient korea
아시아	Asia
아프리카	Africa
안동	간고등어 fish common in this city, ANDONG
영국	England
울산	Ulsan, home of hyundai car company and hyundai shipbuilding in kyungsamnamdo
유럽	Europe
이렇게	In this way
인천	Incheon city
인천공항	Incheon international airport
일본	Japan
저렇게	Like that
전라도	South-western region of south korea
전주	Junju
제주도	Tourist island off south S.Korea
조선	Name for ancient korea culture
종로	Famous street in Seoul
중국	China
지리산	Chili mountain, very beautiful
충청도	Area around daejon city
캐나다	Canada
파리	Paris
평양	Capital of North Korea
프랑스	France
한강	The han river, runs through Seoul
조선	Korea
한나산	Halla-san mountain
조선반도	The Korean peninsula
호주	Australia
조국통일 만세!	"Long Live the Reunification of the Homeland"
벗꽃	cherry blossom
공화국의 영원한 주석	Eternal President of the Republic
영원한 주석 김일성	Kim Il-Sung
김정일	Kim Jong-Il
최고령도자	Supreme Leader
위대한 수령	Great Leader
친애하는 령도자	Dear Leader
김정은	Kim Jong-Un
조국해방전쟁	Korean War
주체	Juche (ideology of North Korea)
아리랑	Arirang, famous Korean folk song in North and South
맵시난다	stylish, cool (North)
일없습니다	"No worries" (North); "That's useless" (South)
